persuade |  v. 说服 vt. 劝说,说服
adaptive |  adj. 适合的,适应的,能适应的
doom |  n. 命运,不幸,宣告,判决 // vt. 命中注定,宣告
spotlight |  n. 照明灯, 车头灯 // 公众注意中心
combat |  n. 争斗,战斗 // vt. 打斗 // vi. 战斗,与…斗争 // adj. 战斗的
provoke |  vt. 激怒, 惹起, 驱使
definitive |  adj. 决定性的，权威性的，确定的，限定的 // n. 限定词
conclusive |  adj. 决定性的, 确实的, 最后的
tentative |  n. 试验,假设 // adj. 试验性质的,暂时的,犹豫不决的
denounce |  v. 告发, 公然抨击
accuse |  vt. 责备,控告
condemn |  vt. 判刑, 谴责, 官方宣称（某事物）有缺陷或不宜使用
criticize |  vt. 批评, 吹毛求疵, 非难 // vi. 批评
restraint |  n. 抑制,克制,束缚
self-restraint |  n.自制
initially |  adv. 最初, 开头
submit |  vt. 呈送, 递交, 主张 // vt. 使服从, 屈服 // vi. 屈从; 忍受
overview |  n. 概观(况),总结 // [计算机] 概貌
mortgage |  vt. 抵押 // n. 抵押；房屋抵押贷款
ownership |  n. 所有权
partnership |  n. 合伙, 合股
sue |  vt. 控告, 起诉 // vi. 请求, 追求, 起诉 // n. (Sue)人名；(日)末(名)；(法)休；(英)休(女子教名Susan、Susanna的昵称)
prosecute |  vt. 对...提起公诉,彻底进行,追捕,经营,从事 // vi.起诉,担任检察官
indict |  v. 起诉, 控告, 指控
flow |  vi.流； 垂； 流出； （谈话、文体等）流畅 // n.流动； 滔滔不绝； 涨潮； 连贯 // vt.使泛滥； 淹没； 排出
capital |  n. 首都,资本,大写字母 // adj. 大写的,资本的，首要的
capitalize |  v. 以大写字母写, 使...资本化, 计算...的现价
capitalism |  n. 资本主义
capitalist |  n. 资本家，资本主义者 // adj. 资本主义的，有资本的
liability |  n. 责任, 可能性，债务, 不利因素
obligation |  n. 义务, 责任
hindrance |  n. 妨害, 障碍, 阻碍物
donate |  vt. 捐赠,转移(电子) // vi. 捐款
donation |  n. 捐赠物, 捐款, 捐赠
donator |  n. 捐赠人
contribute |  vt. 捐助,投稿 // vi. 投稿,贡献,是原因之一
present |  n. 礼物, 现在 // adj. 当面的, 出席的, 现在的 // v. 赠送, 提出, 呈现
ship |  n. 船,舰,船员,飞船 // vt. 以船运送,乘船,运送,进水,在船上工作 // vi. 上船,坐船,运送,在船上工作
complimentary |  adj. 问候的,称赞的,夸奖的,免费赠送的
ward |  n. 守卫, 监护, 病房, 行政区, 由监护人或法院保护的人（尤指儿童） // vt. 守护, 躲开
guard |  n. 守卫者,警戒, 护卫队, 保护 // vt. &vi. 保卫,看守,警惕
award |  vt.授予，奖给，判给； 判归，判定 // n.奖品； （仲裁人、公断人的）裁定； （法院、法官的）判决； 裁定书
staple |  n. 主要产物(要素),原料(地),U形(订书)钉 // adj. 主要的,重要的 // vt. 用订书机装订
repel |  v. 逐退, 使...厌恶, 反驳
cream |  n.乳霜； 精英； 奶油色； 乳脂，奶油 // vt.把…搅成糊状（或奶油状）混合物； 彻底打败，狠揍
drown |  vt. 淹死,沉浸于, // vi. 淹死
angle |  n. 角(度),角落 // vt. 斜移,转变角度 // vi. 钓鱼,谋取,转变角度 // n. (Angle)盎格鲁人
lifeguard |  n. 救生员
assist |  n. 帮助,协助,协助的器械 // vt. 帮助,协助 // vi. 帮助,协助,出席
assistance |  n. 帮助, 援助
assistant |  adj. 助理的；辅助的。 // n. 助手助理；助教，店员
sort |  n. 种类,样子,态度 // v. 分类,整理,排序 // n.[计算机] DOS命令 : 在字符型文件中进行数据排序, 或者将DOS命令的输出进行排序
terror |  n. 恐怖，惊骇，令人惧怕或讨厌的人或事物
pave |  v. 铺设, 安排, 为...铺路
eclipse |  n. 日蚀,月蚀,衰落 // v. 引起日蚀,引起月蚀,使...黯然失色
pour |  n. 流出,倾泻,骤雨 // vt. &vi. 倒,倾泻,蜂涌而来
abide by |  v. 遵守,  服从
abnormal |  adj. 反常的,不正常的,不规则的 // n. 不正常的人
aboriginal |  adj. 原始的, 土著的
abrupt |  adj. 突然的；唐突的, 陡峭的
absorption |  n. 吸收,全神贯注
accomplishment |  n. 成就,完成
accountable |  adj. 负有责任的
adaptable |  adj. 能适应的，适应性强的，可改编的
admirable |  adj. 令人钦佩的, 令人赞赏的
adoring |  adj. 崇拜的，敬慕的 // 动词adore的现在分词形式
advancement |  n. 前进, 进步
agile |  adj. （动作）敏捷的,灵活的,（头脑）机灵的
alarming |  adj. 惊人的, 吓人的
all-round |  adj. 全面的，综合性的
allure |  v. 引诱, 吸引 // n. 诱惑力，吸引力
antisocial |  adj. 非社交的, 不擅社交的, 反社会的
appalling |  adj. 令人震惊的, 可怕的 // 动词appall的现在分词形式
appetizing |  adj. 开胃的, 促进食欲的 // =appetising
arrogant |  adj. 傲慢的, 自大的
artistic |  adj. 艺术的
aspirant |  n. 怀抱大志者, 野心家 // adj. 有抱负的，有野心的
astronomical |  adj. 天文学的，巨大的
authentic |  adj. 可靠的,可信的,真的,真正的
calamity |  n. 灾难, 不幸事件
captivity |  n. 囚禁, 被俘虏
censorship |  n. 检查制度
communication |  n. 沟通,交通,沟通
corruption |  n. 腐败, 堕落, 贪污
creativity |  n. 创造力, 创造
cultivation |  n. 教化, 培养, 耕作
deception |  n. 骗局,诡计,欺骗,欺诈
deterioration |  n. 恶化,降低,退化
disaster |  n. 灾难
elimination |  n. 除去, 消除
embarrassment |  n. 困窘，尴尬，困难
enforcement |  n. 厉行, 执行, 强制
entertainment |  n. 娱乐
equality |  n. 同等, 平等
evaluation |  n. 估价,评价
extinction |  n.熄灭； 消灭，灭绝； 废除； [物]消光，自屏，衰减
freedom |  n. 自由
hygiene |  adj. (hygienic) // n. 卫生
indifference |  n. 不重视, 无兴趣, 漠不关心
individuality |  n. 个性, 人格, 特征
infringement |  n. 违反(侵犯)
interaction |  n. 相互作用, 相互影响
interference |  n. 冲突, 干涉 // [计算机] 干涉
intervention |  n. 插入,介入,调停
jeopardy |  n. 危险
motivation |  n. 动机
participation |  n. 参加, 参与
population |  n. 人口
preservation |  n. 保存
restriction |  n. 限制,约束 // vi. 结果,(作为结果)发生
safety |  n.安全； 安全性； 安全处所； 中卫 // adj.保障安全的
sanitation |  n. 环境卫生(卫生设备, 下水道设备)
scandal |  n. 丑闻,中伤,反感,耻辱
sense |  n. 侦测, 感官, 感觉; 理智; 意义 // vt. 感觉, 了解; 检测
stability |  n. 稳定性,居于修道院
strength |  n. 力量,力气,长处,强度
superstition |  n. 迷信, 没有根据的理论
supervision |  n. 监督, 管理
temptation |  n. 诱惑，引诱； 诱惑物
threat |  n. 威胁, 凶兆
transformation |  n. 转型,转化,改造
treasure |  n. 宝物,财富 // v. 珍爱,重视,储藏
urbanization |  n. 都市化, 城市化
variety |  n. 多样, 种类, 杂耍
violation |  n. 违反,违背,妨碍
vitality |  n. 活力, 生命力
warning |  n. 警告, 预告, 通知 // vbl. 警告, 注意, 通知
wisdom |  n. 智慧,学问
extent |  n. 广度,宽度,长度,大小,范围,范围,程度 // n. [律]&lt;英&gt;扣押, &lt;美&gt;临时所有权令
sharply |  adv. 锐利地, 严厉地, 厉害地
gradually |  adv. 逐渐地
publicize |  v. 宣传, 公布, 广告
esthetic |  adj. 审美的
achieve |  vt. 完成,达到,实现 // vi. 达到目的
decorate |  vt. 装饰, 装修, 授予某人奖章或其他奖状
habitual |  adj. 惯常的, 习惯的
endeavor |  n. 努力, 尽力, 进取心 // vt. 努力,尽力 // vi. 企图, 谋求
picturesque |  adj. 如画的, 生动的, 别致的
target |  n.（服务的）对象； 目标； （射击的）靶子； 目的 // vt.瞄准； 把…作为攻击目标
due to |  因为,由于 // 预定,预期
enclosure |  n. 附件,围墙,围绕
be superior to |  优越于
be subject to |  conj. 服从(以...为条件,须经,易受)
fertilize |  vt.使肥沃； 使受孕； 施肥
specialization |  n. 专门化, 特殊化  // [生]特化器官（机体）
register with | 向......登记；注册
in comparison |  adj. 比较起来(比较地)
interview |  n.  面谈,访问,接见 // vt. 接见,对...进行面谈(试) // vi. 面试, 采访
application form |  申请表
frustrate |  vt. 挫败,击败,破坏 // adj. 无益的,挫败的,挫折的
fee |  n. 费用,封地
supervisor |  n. 监督人, 管理人, 检查员, 督学, 主管人,导师
spare |  adj. 多余的, 闲置的, 备用的, 简陋的 // v. 抽出，饶恕，赦免，节约 // n. 剩余, 备用品
easy-going |  adj. 随和的
considerate |  adj. 考虑周到的,体谅的
low-key |  adj. 抑制的, 软调的
compassionate |  adj. 有同情心的 // vt. 同情
amusing |  adj. 有趣的, 引人发笑的
adorable |  adj. 可崇拜的,值得敬慕的,可爱的
confirmation |  n. 确认, 证实, 基督教的坚信礼
scare off |  吓跑，吓退
unveil |  vt. 揭开,公布 // vi. 揭开
bulky |  adj. 庞大的，笨重的，肥大的
precipitation |  n. 坠落, 沉淀, 凝结; 冰雹
reinforcement |  n. 加固；增援；援军；加强
dozens of |  几十
backward |  adj. 向后的 // adv. 向后
balanced |  adj. 均衡的, 平衡的
baneful |  adj. 有害的, 有毒的，致祸的
barbaric |  adj. 野蛮人的, 极其粗野、残忍或残暴的
barren |  adj. 不育的, 贫瘠的
biased |  adj. 有偏见的
bilingual |  adj. 双语的,用两种语言表达或书写的
boundless |  adj. 无限的(无穷的, 无边无际的)
brutal |  adj. 野蛮的,残暴的
carnivorous |  adj. 食肉的，（植物）食虫的
catastrophic |  adj. 悲惨的,灾难的
challenging |  adj. 大胆的(复杂的, 有前途的, 挑战的) // n. 复杂(有前途, 大胆, 挑战)
civilized |  adj. 文明的, 有礼的
cocky |  adj. 骄傲的, 自大的, 太过自信的
compulsive |  adj. 强制的, 强迫的
conducive |  adj. 有助于...的
considerably |  adv. 非常地, 很, 颇
conspicuous |  adj. 显著的,显而易见的, 显眼的
contemptible |  adj. 可鄙的, 可轻视的
deceitful |  adj. 欺诈(欺骗,虚伪,谎言)
deceptive |  adj. 迷惑的, 虚伪的, 诈欺的
demanding |  adj. 要求多的, 吃力的
destitute |  adj. 穷困的；无的；缺乏的 // n (plural). the destitute，赤贫者，贫民 // vt. 使穷困；夺去
deviant |  adj. 不正常的，离经叛道的 // n. 异常的人
dietary |  adj. 饭食的, 饮食的 // n. 规定的食物, 饮食的规定
diffident |  adj. 无自信的, 客客气气的, 羞怯的
disabled |  adj. 残废的 // n. 残疾人
disappointed |  adj. 失望的
disciplinary |  adj. 训练的, 规律的, 训戒的
discontented |  adj. 不满意的 // 动词discontent的过去式和过去分词
dishonest |  adj. 不诚实的
disobedient |  adj. 不服从的, 不顺从的
disorderly |  adj. 无秩序的, 乱的, 骚动的
distasteful |  adj. 味道差的, 令人反感的, 讨厌的
distracted |  adj. 注意力不集中的，心烦意乱的 // 动词distract的过去式和过去分词
doubtful |  adj. 可疑的, 疑心的, 不确定的
dreary |  adj. 沉闷的,令人沮丧的，情绪低落的
dutiful |  adj. 守本分的, 顺从的, 尽职的
eccentric |  n. 怪人 // adj. 古怪的, 反常的
educational |  adj. 教育的，有教育意义的
emotional |  adj. 感情的, 情绪的
enjoyable |  adj. 有趣的, 愉快的
entertaining |  adj. 引起乐趣的，娱乐性的，令人愉快的 // 动词entertain的现在分词
ethical | adj. 伦理的；道德的；凭处方出售的
everlasting |  adj. 永恒的, 持久的, 无止境的 // n. 永恒，永久盛开的花 // [大写]Everlasting: 上帝
evident |  adj. 明显的, 明白的
exhausted |  adj.耗尽的； 用完的； 筋疲力尽的； 精疲力竭的 // v.用尽( exhaust的过去式和过去分词 )； 使非常疲倦； 详尽讨论（或研究）； 弄空
existing |  adj. 现存的,现有的 // [计算机] 现有的
experienced |  adj. 有经验的
fervent |  adj. 热的, 炎热的, 热心的
fictitious |  adj. 假想的,编造的,虚伪的
greedy |  adj. 贪婪的
grievous |  adj. 痛苦的, 严重的, 充满悲伤的
hereditary |  adj. 世袭的, 遗传的
humane |  adj. 仁慈的，人道的
immoral |  adj. 不道德的
imperative |  n. 命令, 诫命, 需要 // adj. 命令式的, 急需的
impoverished |  adj. 贫困的，赤贫的，耗竭的 // impoverish的过去式和过去分词
improper |  adj. 不合适的, 错误的, 不道德的
incurable |  adj. 不能医治的, 不能矫正的, 无救的 // n. 不治的病人, 无救的人
indecent |  adj. 下流的, 不妥当的
independent |  adj. 独立的, 自主的，私立的，无偏见的 // n. 独立派人士, 无党派者
infectious |  adj. 传染的
intolerable |  adj. 无法忍受的, 难耐的
introverted |  adj. (性格)内向的
inviolable |  adj. 不可侵犯的, 不可亵渎的
irreplaceable |  adj. 不能为其他事物所替代的
irresistible |  adj. 不可抵抗的, 无法抗拒的
isolated |  adj. 分离的,孤立的
victimize |  vt. 使牺牲, 使受骗
industrialize |  v. (使)工业化 // =industrialise(英)
installation |  n. 安装,装置, 军事驻地
municipal |  adj. 市的,市政的 // n. 政府证券
deficit |  n. 赤字,不足，缺乏
disorganize |  vt. 破坏组织, 搅乱秩序, 使混乱
plagiarize |  vt. 抄袭(剽窃,借用)
triumphant |  adj. 得胜的, 得意洋洋的
subscription |  n. 签名,同意,签署物,订阅
auditorium |  n. 礼堂，观众席
presumably |  adv. 推测上,假定上,大概
presume |  vt. 姑且认定，假定，推测，认为是理所当然 // vi. 假设，越权行事
presumable |  adj. 可推测的,可能有的,似真的
provided |  conj. 假如,若是 // adj. 预备好的,由...供给的
polish |  n. 磨光，擦亮；擦亮剂；优雅，精良 // vi. 擦亮，变光滑 // vt. 磨光，使发亮；使完美; 改进 // v. 磨光；修改；润色 // adj. 波兰的
polished |  adj. 擦亮的, 精练的, 优美的 // 动词polish的过去式和过去分词
recruit |  n. 招聘,新兵,新成员 // vt.&vi. 恢复,补充,徵募
recruitment |  n. 征募新兵, 补充
precedent |  adj. 在前的,在先的 // n. 先例,前例
following |  n. 下列各项,部下,党羽 // adj. 下列的,其次的 // prep. 在（某事）以后
ascertain |  vt. 确定,探知,查明
discover |  vt.& vi.发现
clarify |  vt. 澄清,阐明,使...明晰
conceal |  vt. 隐藏, 掩盖
cover |  n. 封面, 盖子, 表面 // v. 覆盖, 涉及, 包含
folklore |  n. 民俗学, 民间风俗, 民间传说
assortment |  n. 分类, 配合, 各色俱备之物
amount to |  vt. 总共达到(总计,等于) // 相当于；意味着
intuition |  n. 直觉, 直觉的知识
instinct |  n. 本能, 天性, 直觉
derive from |  获得，取得，得到；（使）起源于;（使）来自
volatile |  adj. 反复无常的, 挥发性的, 稍纵即逝的, 脾气火爆的 n. 挥发性物质
disdain |  n. 轻蔑 // v. 蔑视
revolve around |  以...为主要内容
appeasement |  n. 平息, 缓和, 满足, 绥靖政策
spring up |  vi. 跳起(发生,萌芽,出现)
prominence |  n. 突出；显著；突出物；卓越
encompass |  vt. 围绕(包围, 拥有, 完成)
deem |  v. 认为, 相信
communal |  adj. 公有的
cycle |  n. 循环,周期,长期,圈,套曲,自行车, // vt. 环行,骑自行车 // vi. 使环行
astronomy |  n. 天文学
old-fashioned |  adj. 老式的，老派的，守旧的 // n. 古典鸡尾酒
outrageous |  adj. 暴虐的,极无礼的,可恶的 //  惊人的,肆无忌惮的,毫无节制的
overwhelming |  adj. 势不可挡的, 压倒的
painstaking |  n. 辛苦,苦心,工夫 // adj. 辛苦的,勤勉的,小心的
particular |  n. 个别项目, 详细说明 // adj. 特别的, 独有的; 挑剔的; 详细的
passive |  adj. 被动的,消极的 // n. 被动性
peaceful |  adj. 安宁的, 和平的
permissive |  adj. 许可的,获准的,自由的
perplexed |  adj. 困惑的, 不知所措的 // 动词perplex的过去式和过去分词
pornographic |  adj. 色情的，春宫的
powerful |  adj. 强有力的
pragmatic |  adj. 实际的, 实用主义的
precious |  adj. 宝贵的,珍贵的,矫揉造作的 // adv. 极其地
preferential |  adj. 先取的, 优先的, 选择的
prevailing |  adj. 盛行很广的,一般的,最普通的 // vbl. 获胜,盛行,流行
probably |  adv. 大概,或许
prone |  adj. 俯卧的, 易于...的, 有...倾向的
provocative |  adj. 气人的, 挑拨的, 刺激的 // n. 刺激物, 挑拨物, 兴奋剂
psychological |  adj. 心理(学)的
refreshing |  adj. 使清爽的, 有精神的 // 动词refresh的现在分词形式
regular |  adj. 有规律的,有规则的,整齐的,正规的
relative |  adj. 相对的,比较的,涉及到的 // n. 亲属,同类事物,相关物
renewable |  adj. 可更新的(可继续的,可更换的,可展期的)
rewarding |  adj. 有报酬的, 有益的
sanitary |  adj. 卫生的, 清洁的
satisfactory |  adj. 令人满意的
savage |  adj. 野性的, 凶猛的, 粗鲁的, 荒野的 n. 野蛮人, 粗人,凶恶的人 vt. 残害, 激烈抨击
seemingly |  adv. 表面上(看上去)
segregated |  adj.分离的
slavish |  adj.无独创性的，盲从的。照搬的； 奴隶的，奴隶性的
slightly |  adv. 些微地, 苗条地
sluggish |  adj. 懒惰的,迟钝的,无精打采的
sociable |  adj. 好交际的, 社交的
stable |  adj. 稳定的；牢固的；坚定的 // n. 马厩；牛棚 // vi. 被关在马厩 // vt. 赶入马房
stubborn |  adj. 顽固的, 倔强的，难对付的
superstitious |  adj. 迷信的
suspicious |  adj. 可疑的,多疑的
symbolic |  n. 代号 // adj. 象征的, 符号的
systematic |  adj. 有系统的, 分类的, 体系的
tasty |  adj. 好吃的
tempting |  adj.诱惑人的 // 动词tempt的现在分词
theoretical |  adj. 理论上的
thrifty |  adj. 节俭的, 节约的，兴旺的，茁壮的
timely |  adj. 及时的,适时的 // adv. 及时的
timid |  adj. 胆怯的,害羞的
tiresome |  adj. 令人厌倦的,讨厌的
tolerant |  adj. 宽容的, 容忍的
toxic |  adj. 有毒的 // n. 有毒物质
trendy |  n. 新潮人物, 穿着时髦的人 // adj. 流行的
truly |  adv. 真实地, 不假
trustworthy |  adj. 可信赖的
ubiquitous |  adj. 到处存在的,遍在的
unable |  adj. 不能的,不会的 // v. 不能,不会
unanimous |  adj. 全体一致的, 一致同意的
unbelievable |  adj. 难以置信的
uncomfortable |  adj. 不舒服的, 不自在的
undeniable |  adj. 不可否认的，无可辩驳的
undesirable |  adj. 不受欢迎的, 不良的，不合意的，讨厌的 // n. 不受欢迎的人，不良分子
unprecedented |  adj. 空前的,前所未有的
unreasonable |  adj. 不合理的, 过度的, 不切实际的
utilitarian |  adj. 功利的, 实用的
virtuous |  adj. 有品德的, 善良的, 贞洁的
void |  n. 空虚,空白, 真空 // adj. 空的,缺乏的,无效的 // vt. 清空,释放,取消,离开 // vi. 排泄
vulgar |  adj. 通俗的,粗俗的
wholesome |  adj. 有益健康的, 合乎卫生的, 健全的
zealous |  adj. 热心的, 狂热的，热衷的
furthermore |  adv. 而且, 此外
constant |  adj. 经常的, 不变的 // n. 常数, 恒量
manual |  adj. 手工的,体力的 // n. 手册,指南,键盘
behalf |  n. 代表；利益
additional |  adj. 附加的, 另外的
censure |  n. 责难, 非难 // v. 非难, 责备，公开谴责
crawl |  vi. 爬行，卑躬屈膝，自由式游泳 // n. 爬行, 匍匐而行，[体育]自由式游泳
presuppose |  v. 预先假定, 预料, 预料为必要的条件
anticipation |  n. 预期, 预料
contrive |  vt. 1. (不顾困难地)促成某事2. 巧妙地策划；精巧地制造（如机器） vi. 1. (不顾困难而) 设法做到(正式)
vibrant |  adj. 震颤的, 响亮的, 充满活力的, 精力充沛的, (色彩)鲜明的
opaque |  adj. 不透明的, 难懂的
vague |  adj. 模糊的,不明确的,说话含糊不清的,茫然的
transparent |  adj. 透明的, 明显的, 清晰的
fulfillment |  n. 满足，完成，履行
aspire |  vi. 渴望；立志；追求
recession |  n. 后退,凹入的地方,不景气
subsidize |  v. 给与补助金,给与奖助金,贿赂
familiarize |  vt. 使熟悉
optical |  adj. 眼睛的, 视觉的, 光学的
gloss |  n. 光彩, 注释 // v. 使光彩, 注释
synonym |  n. 同义词,换喻词
synonymous |  adj. 同义的
sustainable |  adj. 可以忍受的；足可支撑的；养得起的；可持续的
chaos |  n. 混乱
reclaim |  v. 开垦, 纠正, 收回
retrieve |  vt. 挽回,恢复,回忆,补偿 // vi. 找回猎物 // n. 取回,恢复
retake |  vt. 夺回, 取回, 再取, 补拍 // n. 重拍
recycle |  vt. 使再循环,再利用,再制 // vi. 循环 // n. 再循环
blast |  n. 爆破,冲击波,气流,一阵,汽笛声 // vi. 爆破,突然发出声音 // vt. 喷射,炸掉
requisite |  adj. 必要的, 需要的 // n. 必需品
warfare |  n. 战争,冲突
hostility |  n. 敌意, 敌对状态, 公开战争
war |  n. 战争 // vi. 作战
conflict |  n.冲突； 战斗； 相互干扰； 矛盾 // vi.抵触； 争斗； 战斗； 冲突
peace |  n. 和平,安静
thrill |  n. 震颤,激动 // vt. (使)震颤,抖颤,激动 // vi. 变激动
excite |  v. 刺激, 使...兴奋, 激励
delight |  n. 快乐,高兴 // vi. 给与乐趣,使高兴 // vt. 使高兴
global |  adj. 全球性的, 全局的
perceive |  v. 察觉, 感觉, 认知, 理解
detect |  vt. 发现,探测信息,侦查 // vi. 当侦探
comprehend |  vt. 充分理解(综合,包含)
barely |  adv. 少量地,几乎不地,勉强
recipient |  n. 接受者, 收信人
receiver |  n. 接收器, 收款员, 接待者，听筒
contributor |  n. 贡献者, 捐助者, 赠送者，投稿人
strategy |  n. 战略, 策略
strategic |  adj. 战略的,重要的,基本的
exotic |  adj. 异国的,外来的,奇异的,脱衣舞的 // n. (复数)异国风格的事物,脱衣舞者
foreign |  adj. 外国的,外交的,不相关的
native |  adj. 本国的,本土的,出生地的,天生的 // n. 本地人,土著人
acid |  adj. 酸的 // n. 酸, 酸味物质
afforestation |  n. 造林
ancestor |  n. 祖宗,祖先,原种
antiquated |  adj. 陈旧的, 过时的，年老的 // 动词antiquate的过去式和过去分词
archeologist |  n. 考古学家 // =archaelogist
biodegradable |  adj. 生物所能分解的
biosphere |  n. 生物圈
carcinogen |  n. 致癌物
coexist |  vi. 同时存在(于同一处), 共存
congestion |  n. 混杂,拥挤,过剩 // [计算机] 拥挤
cornerstone |  n. 隅石，奠基石
cuisine |  n. 烹饪,佳肴
decomposition |  n. 分解,腐败,变质
deforestation |  n. 森林开伐, 滥伐森林
densely-populated |  adj. 人口稠密的
desalination |  n. 脱盐(作用)
desertification |  n. (土壤)荒漠化, 沙漠化
devastation |  n. 破坏, 劫掠
download |  v. 下载
efficiency |  n. 效率；效能；功效
electronic |  adj.电子的； 电子操纵的； 用电子设备生产的； 用电子设备完成的
emulate |  vt. 效法, 尽力赶上, 仿真 // [计算机] 仿真
exploitation |  n. 开发,开采,自私的利用
fad |  n. 时尚, 一时流行的狂热
festivity |  n. 欢宴, 欢庆
globalization |  n. 全球化 // =globalisation(英)
greenhouse |  n. 温室, 暖房
grimy |  adj. 污秽的, 肮脏的
hardware |  n. 五金器具 // n. (计算机) 硬件
hazardous |  adj. 危险的,冒险的,碰运气的
hinder |  adj. 后面的 // vt. 阻碍,打扰 // vi. 阻碍
hyperlink |  n. （电脑）超链接
imbalance |  n. 不平衡,失调
imperil |  vt. 使陷于危险中, 危及
impurity |  n. 不纯, 杂质
incinerate |  v. 焚化,毁弃 // vi. 把...烧成灰, 烧弃 // vt. 焚化(废物),火化
industrialized |  adj. 工业化的 // 动词industrialize的过去式和过去分词形式
inundate |  v. 浸水, 向泛滥, 淹没
longevity |  n. 长寿
menace |  n. 威胁, 胁迫 // v. 威吓, 胁迫
misuse |  vt.&amp;n. 误用,滥用
mutation |  n. 变化, 转变, 母音变化
nonrenewable |  adj. 不可再生的
novelty |  n. 新奇,新奇的事物,小装饰
overcrowding |  n. 过度拥挤，挤满 // 动词overcrowd的过去式和过去分词
overgraze |  vt. 使过度放牧
practicality |  n. 实际,实用,实用性,实际的事情
protein |  adj. 蛋白质的 // n. 蛋白质
purify |  v.(使）净化，（使）精炼，涤罪
radiation |  n. 辐射,放射线
rainfall |  n. 降雨，降雨量
reforestation |  n.重新造林
reliability |  n. 可靠性
restore |  vt. 恢复,归还,翻新
reuse |  v. 再使用 // vt. 重新使用
robot |  n. 机器人
saline |  adj. 含盐的, 咸的 // n. 生理盐溶液，盐湖
sandstorm |  n. 大风沙，沙尘暴
sewage |  n. 脏水, 污水
smelly |  adj. 有使人难受的气味的,臭的
software |  n. 软件
spell |  v. 拼写，缓慢地或吃力地读 // n. 魅力，符咒 // vt. 用符咒镇住(某人) // n. 一段时间，轮班 // v. 轮班，休息
sperm |  n. 精液, 精子 // n. 与抹香鲸有关的物质(如鲸脑油) // pref. 表示“精液，精子，种子”（=spermo-,sperma-，spermi-）
trash |  n. 废物,垃圾 // vt. 废弃,擦去,捣毁 // vi. 捣毁
unsanitary |  adj. 不卫生的，有碍健康的，不健康的 // =insanitary
vermin |  n. 害虫, 寄生虫
vicious |  adj. 恶毒的, 恶意的, 凶残的, 剧烈的, 严重的
wasteland |  n. 荒地, 未开垦地
block |  n.块； 街区； <英>大楼，大厦； 障碍物，阻碍 // vt.阻止； 阻塞； 限制
blockade |  n. 阻塞，封锁，阻碍物 // v. 封锁，挡住
blockage |  n. 封锁, 妨碍
pregnant |  adj. 怀孕的，意味深长的,含蓄的，富于想象力的
pregnancy |  n. 怀孕
devise |  vt. 设计,遗赠 // n. 遗赠(的财产)
relate |  vt.& vi.（把…）联系起来； 讲，叙述（故事等） // vt.讲述，叙述； 使…有联系； 建立或展示联系 // vi.有联系； 涉及； 符合； 发生共鸣
relative |  adj. 相对的,比较的,涉及到的 // n. 亲属,同类事物,相关物
relation |  n. 关系,家人,亲戚,叙述,陈述
proportion |  n. 比例,均衡,部份 // vt. 使成比例,使均衡,分摊
proportional |  adj. 成比例的,相称的 // n. [数]比例项
proportionate |  adj. 成比例的, 相称的 // vt. 使相称, 使成比例
gauge |  n. 测量标准,轨距,口径,直径,测量仪器 // vt. 测量,估计,判断
slippery |  adj. 滑的
tempt |  vt. 诱惑；引起；冒…的风险；使感兴趣
appeal |  n. 恳求, 上诉, 吸引力 // n. 诉诸裁决 // v. 求助, 诉请, 呼吁; 有吸引力
entice |  v. 诱骗, 引诱
altitude |  n. 高度,海拔,高地
exploit |  n. 功绩,勋绩 // vt.&vi. 开发,利用,开拓
component |  n. 元件, 组件, 成份 // adj. 组成的, 构成的
ingredient |  n. 成分, 因素
element |  n. 成分,要素,元素,基本原理,(复数)恶劣天气
constituent |  n. 成份,选民,构成物 // adj. 构成的,组织的,有提名权的
marsupial |  n. 有袋动物 // adj. 袋的, 袋状的，有袋动物的
symbol |  n. 符号, 标志, 象征
symbolism |  n. 象征主义, 象征, 符号化
symbology |  n. 象征学,象征的使用
symbolic |  n. 代号 // adj. 象征的, 符号的
symbolical |  adj. 象征性的，符号的，象征主义的 // =symbolic
deviance |  n. 异常
function |  n. 功能, 函数, 重大聚会 // vi. 运行, 起作用
functional |  adj. 功能的,有功能的,实用的
accommodation |  n. 住处，膳宿；调节；和解；预订铺位
maintain |  vt. 维持; 维修, 保养; 坚持; 断言
surveillance |  n. 监视,监督
colony |  n. 侨民,侨居地,殖民地,聚居(地)
colonist |  n. 殖民地居民, 殖民者
colonial |  adj. 殖民地的 // n. 殖民地居民
colonialism |  n. 殖民主义
stack |  n. 堆叠,堆 // vt. 堆积,成叠放在 // vi. 堆成一堆
haystack |  n. 大干草堆 // =hayrick
loan |  n. 贷款, 借出, 债权人 // v. 借, 供应货款, 借给
miserable |  adj. 悲惨的,痛苦的,贫乏的
consultant |  n. 顾问, 咨询专家
accreditation |  n. 委派, 信赖
afford |  vt. 提供,负担得起的(后果,损失等),给予
affordable |  adj. 支付得起的, 不太昂贵的
conserve |  n. 蜜饯,果酱 // vt. 保存,与糖放在一起,保持
split |  n. 劈开, 裂片, 裂口 // adj. 分散的 // v. 分离, 分开, 劈开
crucial |  adj. 关键的,决定性的
crucially |  adv. 关键地；至关重要地
enrich |  vt. 使富足,使肥沃，添加元素
enrichment |  n. 丰富, 改进
privilege |  n. 特权,特别恩典,基本人权,荣幸 // vt. 给特权,免除
privileged |  adj.享有特权的；特许的，专用的；秘密的，保密的；幸运的，荣幸的
underprivileged |  adj. 贫穷的
graphic |  adj. 生动的,图表的 // n. 图表
leisure |  n. 闲暇；空闲；安逸 // adj. 空闲的；有闲的；业余的
assistance |  n. 帮助, 援助
guideline |  n. 指引，指导方针
abomination |  n. 憎恨, 痛恶, 可憎的事物
abortion |  n. 流产,堕胎
acclimatize |  v. 使...适应新环境, 使...服水土
adventurous |  adj. 爱冒险的,大胆的,危险的
adolescence |  n. 青春期
aggression |  n. 进攻, 侵犯, 侵害, 侵略
ambition |  n. 雄心,野心,抱负,精力 // vt. 有...野心,追求
atrocity |  n. 暴行
avarice |  n. 贪财, 贪婪
avocation |  n.娱乐，消遣，副业, 嗜好
bawdry |  n. 淫猥下流的言语，不贞
bereave |  v. 剥夺
bias |  n. 偏见，斜纹 // vt. 使偏心
bully |  n. 欺凌弱小者,土霸,开球 // vt. 威胁,恐吓,欺负 // adj. 第一流的；特好的
cartoon |  n. 动画片 // vt. 为...画漫画
coeducation |  n. 男女同校
commiserate |  v. 怜悯, 同情
companionship |  n. 友谊, 陪侣关系，交情
condone |  vt. 宽恕；赦免
conscience |  n. 良心, 责任心, 顾忌
decency |  n. 得体, 礼貌，体面 // （复数）decencies:礼仪，行为规范
deify |  vt. 神化，把…当作神来崇拜或敬畏，崇拜
disgrace |  n. 耻辱, 不名誉 // v. 耻辱, 使...失体面
dishonesty |  n. 不诚实，不法行为
dupe |  n. 受骗的人, 上当者 // vt. 欺骗, 愚弄
ego |  n. 自我, 自负, 自尊心
envy |  vt. &vi. 嫉妒,羡慕 // n. 妒忌,羡慕
erode |  vt. 腐蚀,侵蚀 // vi. 受到侵蚀
erotic |  adj. 性爱的, 性欲的, 色情的 // n. 好色之徒, 恋爱诗
euthanasia |  n. 安乐死
falsehood |  n. 谎言, 虚假
forgiving |  adj. 宽容的,  宽恕的  // 动词forgive的现在分词
handicraft |  n. 手工艺, 手艺, 技巧
heartless |  adj. 无情的, 残酷的 // adj.
heirloom |  n. 传家宝，[法律]动产继承物
homosexual |  adj. 同性恋的 // n. 同性恋
hypocrisy |  n. 伪善
immorality |  n. 不道德, 无道义
infiltrate |  v.（使）渗透，（使）渗入
ingratitude |  n. 忘恩负义
insidious |  adj. 隐伏的, 暗中为害的，阴险的, 诱人上当的，（疾病等）不知不觉恶化的
lenient |  adj. 宽大的, 仁慈的
lewd |  adj. 淫荡的
libel |  n. (文字)诽谤, 侮辱 // vt. 诽谤, 中伤, 损害名誉 // vi. 发表诽谤言论
loyalty |  n. 忠诚, 忠心
maltreat |  vt. 虐待
merciless |  adj. 无慈悲心的, 残忍的
modish |  adj. 流行的, 时髦的
money-oriented |  一切向钱看
moribund |  adj. 垂死的，即将结束的
national |  adj. 国家的,民族的 // n. 国民
obedience |  n. 服从, 顺从
obscenity |  n. 猥亵的话(或行为)
orthodox |  adj. 正(传)统的
outdated |  adj. 旧式的,落伍的,过时的 // v. 使时 // vbl. 过时
piety |  n. 虔诚
profanity |  n. 沾污神圣不敬,亵渎,该受惩罚的言语
promiscuity |  n. 混乱, 杂乱, 放荡
propagandize |  v. 宣传，传教，传道
quintessence |  n. 精粹,(物体)最纯粹的形体,典型
reciprocate |  v. 互换, 交换, 报答，往返运动
relic |  n. 神圣的遗物, 遗迹, 纪念物
seduce |  vt. 怂恿,瞒骗,引诱
slander |  n. 中伤, 毁谤 // v. 中伤, 毁谤
tabloid |  n. 小型报, 小型画报, 药片 // adj. 扼要的
taboo |  n. 禁忌,禁止接近,禁止使用 // adj. 禁忌的 // vt. 禁忌,禁制,禁止
tribal |  adj. 部落的, 种族的
unethical |  adj. 不道德的, 缺乏职业道德的
vice |  n. 恶习,恶行,罪恶,缺陷,恶癖,老虎钳 // vt. 钳住 // prep. 代替,副,次
vile |  adj. 恶劣的, 简陋的, 低廉的
westernize |  v.使 ... 西洋化,使 ... 欧化
hectare |  n. 公顷
cohesion |  n. 凝聚力, 团结
landmark |  n. 陆标, 划时代的事, 地界标
insulate |  v. 使...绝缘, 隔离 // [计算机] 绝缘
possess |  v. 持有,克制,为...着迷
possessed |  adj. 疯狂的；着魔的
possession |  n. 财产, 所有, 拥有
possessive |  n. 所有格 // adj. 所有格的,拥有的，占有的
dispossessed |  adj. 被剥夺财产的
comparatively |  adv. 比较地,相当地,多少
perform |  v. 执行, 表演, 做
performance |  n.表演； 演技； 表现； 执行
performer |  n. 表演者, 执行者
stake |  n. 木桩,赌注,股份 // vt. 打赌,下赌注；用桩支撑
strain |  n. 张力；拉紧；负担；扭伤；血缘 // vi. 拉紧；尽力 // vt. 拉紧；滥用；滤去；竭力
flavor |  n. 滋味, 香料, 风格 // vt. 加味于
assign |  v. 分配,指派 // n.[计算机] DOS 命令将驱动器符重指向第二个驱动器符
herbivore |  n. 草食动物
circulation |  n. 流通,循环,发行量,消息传播
flow |  vi.流； 垂； 流出； （谈话、文体等）流畅 // n.流动； 滔滔不绝； 涨潮； 连贯 // vt.使泛滥； 淹没； 排出
snack |  n. 小吃,点心 // v. 吃零食,吃点心
sole |  adj. 唯一的, 独占的 // n. 脚底, 鞋底; sole 或soles 鳎鱼 // vt. 给(鞋)换底
premium |  n. 额外费用, 奖金; 奖品保险费 // n. (商)溢价 // adj. 高价的; 优质的
discount |  n. 折扣, 贴现率 // vt. 打折扣, 贴现, 不重视，不全信 // vi. 贴现, 减息贷款
capacity |  n. 能力, 容量, 容积; 资格, 职位 // adj. (达到最大容量)满的
poisonous |  adj. 有毒的
content |  n. 内容, 目录, 含量 // adj. 满足的, 满意的 // vt. 使...满足, 使...安心
contentment |  n. 满足，使人满足的事
discontented |  adj. 不满意的 // 动词discontent的过去式和过去分词
contented |  adj. 满足的, 心安的 // 动词content的过去式和过去分词形式
artificial |  adj. 人造的,虚伪的,武断的
compromise |  n. 妥协, 折衷, 折衷案 // vt. 妥协处理, 危害 // vi. 妥协, 让步
rigorous |  adj. 严厉的,严酷的,严格的,细致的
adapt |  vt. 使适应,改编 // vi. 适应，适合
adaptation |  n. 改编,适应,改编成的作品
adaptable |  adj. 能适应的，适应性强的，可改编的
adaptive |  adj. 适合的,适应的,能适应的
moral |  adj. 道德(上)的,有道德的 // n. 品行,寓意,道德
morality |  n. 道德, 美德, 品行, 道德观
moralism |  n. 道德主义, 说教
moralistic |  adj. 说教的；道学的；道德家的；注意道德的
participate |  vi.参加某事； 分享某事 // vt.得到或接受某部分东西
participation |  n. 参加, 参与
deserve |  vi. 应该得到 // vt. 应受,值得
detach |  vt. 使分离, 拆卸 // [计算机] 脱离
detachable |  adj. 可拆下的, 可分开的
detachment |  n. 分离，分遣，冷漠，公正
disconnect |  vt. 使分离 // vi. 断开，拆开
separate |  n. 分开, 抽印本 // adj. 分开的, 各自的, 单独的 // v. 分开, 隔开, 分居
attach |  v. 附上, 系上, 贴上, 使依恋
unbiased |  adj. 公正的
critical |  adj.批评的，爱挑剔的； 危险的，危急的； 决定性的； [物]临界的
cynical |  adj. 愤世嫉俗的,吹毛求疵的
subjective |  adj. 主观的 // n. 主格,主观事物
objective |  adj. 客观的, 目标的 // n. 目标, 目的; 物镜 // n. =objective case 宾语
willing |  adj. 愿意的, 心甘情愿的
spray |  n. 水沫,喷雾器 // vt. &vi. 喷雾,扫射,喷射
insight |  n. 洞察力
insightful |  adj. 富有洞察力的,有深刻见解的
spade |  n. 铲子, 铁锹, 在扑克牌中指黑桃 // v. 铲 // vt. (用铲子)铲
charcoal |  n. 木炭, 炭笔
associate |  vt.（使）发生联系； （使）联合； 结交； 联想 // vi.联盟； 陪伴同事 // n.合伙人； 伴侣，同志； 非正式会员 // adj.联合的； 合伙的； 非正式的； （性质上）有密切联系的
combine |  n. 集团,联合收割机 // v. 化合,结合,联合 // vi. 结合,联合 // vt. 使结合,使联合
join |  v. 参加, 结合, 联合, 加入
refreshment |  n. 恢复，精神爽快，提神之事物；点心，茶点
beverage |  n. 饮料
geometry |  n. 几何,几何学
geometric |  adj. 几何学的, 几何学上的, 几何学图形的
abhorrent |  adj. 令人憎恨的, 可恶的，背离的
activist |  n. 活动分子, 积极分子
amoral |  adj. 与道德无关的, 超道德的
anesthetic |  n. 麻醉剂, 麻药 // adj. 麻醉的, 无知觉的
animal |  n.动物，兽，牲畜； <俚>家畜，牲口； <俚>畜生（一般的人）； 兽性 // adj.动物的； 肉体的； 肉欲的
anthropomorphism |  n. 神人同形同性论
antibiotic |  adj. 抗菌的 // n. 抗生素
brazen |  adj. 黄铜制的,厚颜无耻的 // v. 使...厚颜,使...无耻
bullfighting |  斗牛
chimpanzee |  n. 黑猩猩
clinical |  adj. 临床的
corporal |  adj. 肉体的, 身体的 // n. (陆军或空军)下士
cowardice |  n. 懦弱
dependence |  n. 依赖, 信赖，上瘾
deterrent |  adj. 制止, 防止, 挽留 // n. 挽留的事物, 妨碍物
diffidence |  n. 无自信, 内向, 羞怯
discourteous |  adj. 失礼的, 无礼貌的
disobey |  vi. 违反 // vt. 不服从
disrespect |  n. 不敬, 无礼 // vt. 不尊敬
dropout |  n. 中途退出者
edify |  vt. 建立，训导，教导，启发， 薰陶
egoist |  n. 自我主义者
entice |  v. 诱骗, 引诱
estranged |  adj. 疏远的, 隔离的 // 动词estrange的过去式和过去分词形式
fantastic |  adj. 极好的,难以相信的,奇异的,幻想的
formative |  adj. 形成的, 造形的，影响发展的 // n. 造字要素
gregarious |  adj.  群居的，爱社交的
homesick |  adj. 想家的
idol |  n. 偶像 // n.菩萨
ill-bred |  adj. 没有教养的,  没有礼貌的, 粗野的
illiteracy |  n. 文盲
immature |  adj. 不成熟的
impetuous |  adj. 冲动的, 猛烈的, 轻率的
inappropriate |  adj. 不适当的,不相称的
inculcate |  v. 教授,谆谆教诲,教育
individualism |  n. 个人主义
indoctrinate |  v. 灌输思想，传授
indolent |  adj. 懒惰的，慢性的
inexperience |  n. 无经验, 不熟练
interpersonal |  adj. 人与人之间的,人际关系的
jealousy |  n. 妒忌
law-abiding |  adj. 守法的
malnutrition |  n. 营养不良
misbehave |  v. 行为无礼貌, 行为不端, 作弊
misguide |  vt. 误导, 使误入歧途
myopia |  n. 近视, 缺乏远见
narcotic |  n. 麻醉药, 镇静剂 // adj. 麻醉的, 催眠的
naughty |  adj. 顽皮的,淘气的，粗俗的
obsession |  n.[U]痴迷；困扰,成见 //  [C]使人痴迷的人（或物）
parental |  adj. 父母的
pornography |  n. 色情文学, 色情描写
prodigy |  n. 惊人的事物, 奇迹，神童，天才，预兆
puberty |  n. 青春期
rowdy |  adj. 吵闹的, 粗暴的
savor |  n. 滋味, 气味, 食欲, 特定的味道或气味, 一种有特色的性质 // vi. 有...的滋味, 有...气味 // vt. 加调味品于, 使有风味, 尝到或闻到, 尽情享受
schooling |  n. 学校教育, 学费 // 动词school的现在分词形式
self |  n. 自我, 自己, 本身
sequacious |  adj. 好跟随在别人后头走的, 卑贱的, 合于逻辑的
slothful |  adj. 怠惰的, 懒惰的, 迟钝的
thrift |  adj. 节约, 节俭 // n. 节俭, 节约
traumatize |  vt. 使受损伤，使受精神上创伤
truancy |  n. 逃学, 旷课；玩忽职守
uncivilized |  adj. 未开化的，不文明的 // =uncivilised(英) // 动词uncivilize的过去式和过去分词
unsociable |  adj. 不爱交际的，不与人亲近的，不和气的
vanity |  n. 虚荣心,浮华,无价值的东西 // adj. 虚荣心的
vex |  vt. 恼怒，使恼火
vulgarity |  n. 粗俗, 粗鄙, 卑俗性
willful |  adj. 任性的, 故意的, 有意的
willpower |  n. 意志力
wrongdoer |  n. 做坏事的人，罪犯，违法者
household |  adj. 家庭的, 家喻户晓的 // n. 家庭, 户
evolution |  n. 进化, 发展, 进展
interfere |  vi. 妨碍,冲突,干涉
interference |  n. 冲突, 干涉 // [计算机] 干涉
evolutionary |  adj. 发展的(展开的,调优的)
incentive |  adj. 刺激的, 鼓励的 // n. 刺激, 鼓励, 动机
motivation |  n. 动机
impetus |  n. 动力,推动力
adverse |  adj. 不利的；有害的；反面的
adversity |  n. 不幸, 灾难
database |  n. 数据库
succumb |  v. 屈从, 死
transmit |  vt. 传输, 传送, 代代相传, 传达 // vi. (以无线电或有线电的方式)发送信号
transmitter |  n. 传达人, 发射机，发射台
transmission |  n. 传输, 播送, 变速器, 传递的信息
advanced |  adj. 高级的, 先进的
accompany |  vt. 陪伴, 伴随，给...伴奏 // vi. 伴奏
accompaniment |  n. 伴唱（奏），伴随物, 补充物，伴随情况
accompanist |  n. 伴奏者
confidence |  n.信心； 信任； 秘密
self-confidence |  n. 自信
confident |  adj. 确信的, 自信的
typical |  adj. 典型的, 有代表性的
typically |  adv. 代表性地, 作为特色地
tag |  n. 标签,附属物,名称,谚语 // vt. 附以签条,尾随,添饰,指责,连接 // vi. 紧随,尾随
price |  n. 价格,代价,价值 // vt. 定格,标价,比较价格
brand name |  商标名称，牌子
ingredient |  n. 成分, 因素
invisible |  adj. 看不见的,无形的 // n. 隐形人(或物品)
observe |  v. 观察, 遵守, 注意到
observant |  adj. 观察力敏锐的，守纪的
observation |  n. 观察,观察力,评论 // adj. 被设计用来观察的
observational |  adj. 根据观察的，监视的
differ |  vi. 不一致,不同(意见)
transit |  n. 经过,运输 // vt. 穿越,旋转 // vi. 越过
transition |  n. 过渡,转变
forecast |  n. 预测,预报 // vt. &vi. 预测
transportation |  n. 运输, 运输系统, 运输工具
delivery |  n. 递送, 交付, 分娩
anthropologist |  n. 人类学家
accurate |  adj. 准确的, 精确的
inaccurate |  adj. 不准确的，错误的
accuracy |  n. 准确(性), 精确度
incredible |  adj. 难以置信的, 惊人的
incredibly |  adv. 难以置信地, 不可思议地
incredulity |  n. 不易相信, 深疑, 怀疑心
enroll |  vt. &vi. 登记,使加入,卷起
convince |  vt. 说服, 使...相信
convincing |  adj. 使人信服的, 有力的, 令人心悦诚服的 // vbl. 使...信服, 使...明白
unconvincing |  adj. 不足以令人相信的
fragment |  n. 碎片 // vt. &vi. 变成碎片 // [计算机] 碎片
fragmentary |  adj. 碎片的，碎块的, 碎屑状的, 零碎的, 不完全的
withstand |  vt. 对抗,经得起,承受
regarding |  prep. 关于, 至于
regard |  vt.认为； 注视； 涉及； 尊敬 // vi.凝视； 留意 // n.凝视； 留意； 尊敬； 问候
astronaut |  n. 宇航员
granite |  n. 花岗岩；坚毅；冷酷无情
dismiss |  vt.解雇，把…免职； 遣散，解散（队伍等）； 驳回，拒绝受理； 搁置 // vi.解散
dismissal |  n. 免职, 解雇
dismissive |  adj.拒绝的； 轻蔑的，鄙视的
strengthen |  vt. &vi. 加强,变坚固
entail |  vt. 使必需,使蒙受;限定继承 // n. 限定继承权
scarce |  adj. 缺乏的,不足的,稀少的,罕见的 // adv. 勉强
scarcely |  adv. 几乎不, 简直没有, 勉强
scarcity |  n. 缺乏,不足,缺少
ozone |  n. 臭氧, 新鲜空气
ailment |  n. 小病, 疾病
elaborate |  adj. 精细的, 详尽的, 精心的 // v. 详细地说明, 用心地作, 推敲
atmosphere |  n. 大气, 气氛，空气, 格调, 情趣, 气压
atmospheric |  adj. 大气的，大气层的，制造气氛的
affection |  n. 慈爱,爱,感情,作用,影响
anarchy |  n. 无政府状态, 混乱
apathy |  n. 缺乏感情或兴趣,冷漠
authoritarian |  adj. 权力主义的, 独裁主义的 // n. 独裁主义者，权力主义者
avaricious |  adj. 贪财的, 贪婪的
avid |  adj. 渴望的,贪婪的,热心的
breadwinner |  n. 养家糊口的人.,负担家计的人
breed |  n. 品种,族类 // vt. 养育,繁殖,引起 // vi. 繁殖
bribery | n. 贿赂行为, 行贿, 受贿
childhood |  n. 童年,幼年
commute |  vi. 交换,通勤,折偿 // vt. 交换,减刑,改变付款方式 // n. 乘车上下班,通勤
competitive |  adj. 竞争的, 比赛的
conformity |  n. 适合,一致,相似
copyright |  adj. 版权(的) // n. 版权,著作权
democracy |  n. 民主,民主制,民主国家
discontent |  n. 不满 // adj.不满的 // v.令(人)不满
disparity |  n. 不一致
dissipation |  n. 浪费；消散；[物] 损耗
egalitarian |  adj. 平等主义的 // n. 平等主义者
employment |  n. 工作,职业,雇用,使用
encroach |  v. 侵占,蚕食 // vi. 侵占,侵犯,侵害 // vt. 侵犯
extremism |  n. (政治上)极端主义, 过激论
feminist |  n. 男女平等主义者,女权扩张论者 // adj. 男女平等主义的,女权扩张论的
financial |  adj. 金融的,财政的
futile |  adj. 无效的, 无用的
greenhorn |  n. 初学者, 新手，没经验的人
guardian |  n. 保护人, 监护人
humiliation |  n. 耻辱, 丢脸
hypocrite |  n. 伪君子, 伪善者
impoverishment |  n. 贫穷，穷困
inalienable |  adj. 不可剥夺的
inborn |  adj. 天生的, 生来的, 生成的
inequality |  n. 不平等，不平均，差异，多变性，&lt;数&gt;不等式
inhospitality |  n. 冷漠，冷淡，不和气
inhumane |  adj. 无人情味的,薄情的,残忍的
insecticide |  n. 杀虫剂
isolation |  n. 隔离, 孤立
legislator |  n. 立法者
legitimacy |  n. 合法, 适法, 正当
liberation |  n. 解放，解放运动（为获得平等权利和地位的行为）
maternity |  n. 母性, 母道, 妇产科病房 // adj. 孕妇的, 母性的
media |  n. (medium的复数)媒体,新闻媒介,传播媒介
mobility |  n. 可动性, 变动性, 情感不定
omnivorous |  adj. 杂食的，涉猎广泛的
oppression |  n. 压抑, 沉闷, 压迫手段
orphanage |  n. 孤儿的身份，孤儿院
pastime |  n. 消遣,娱乐
pathological |  adj. 病理学的
pauper |  n. 贫民, 被救济者, 穷人
pessimism |  n. 悲观, 悲观主义
predator |  n. 食肉动物,掠夺者
prerogative |  adj. (有)特权的 // n. 特权
primate |  n. 灵长目动物 // n. (常大写)首席主教
racism |  n. 种族主义，种族歧视；人种偏见
repression |  n.抑制，压抑，制止
sacred |  adj. 神圣的,受尊重的
sentient |  adj. 有知觉的, 知悉的
snobbish |  adj. 势利的
sovereignty |  n. 主权, 独立国
stipulate |  vt. &vi. 规定,保证 // adj. 有明文规定的
therapeutic |  adj. 治疗的
torment |  n. 苦痛, 拷问 // v. 使苦恼, 拷问
trespass |  n. 非法侵入，罪过，[法]侵害诉讼 v. 非法侵入,侵害，冒犯；客气话〕叨扰，打扰，妨碍 (on; upon).
underprivileged |  adj. 贫穷的
unjustifiable |  adj. 不合道理的, 不能认为是正当的, 不能分辩的
unlawful |  adj. 非法的, 私生的
vaccine |  n. 疫苗
vegetarianism |  n. 素食主义
veterinarian |  n. 兽医
extensive |  adj. 广泛的,广阔的
substitute |  n. 代替者,代用品 // v. 代替 // vi. (for)代替 // vt. 用...代替,代以
substitution |  n. 代理,替换,交换
exemplify |  vt. 例证,例示
exemplification |  n. 范例, 举例, 例证
demonstrate |  vt. 示范, 演示, 证明 // vi. 示威
illustrate |  vt. 举例说明,作图解 // vi. 举例
minimal |  adj. 最低限度的,最小的
minimalist |  adj.极简抽象艺术的，极简抽象风格的； 最低必须限度的 // n.极简抽象派艺术家，极简派音乐家； 保守派
maximum |  n. 极点, 最大量, 极大 // adj. 最高的, 最大极限的
exclude |  vt. 除外,排除,拒绝 // [计算机] 排除
exclusion |  n. 排除,除外,逐出
exclusive |  adj. 独占的, 唯一的, 排外的; 高价的, 时髦的 // [计算机] 互斥的 // n. 独家新闻, 独权
tradition |  n. 传统, 惯例
traditional |  adj. 传统的
resume |  v. 再继续, 重新开始 // n. 简历, 履历; 摘要
resumption |  n. 恢复(再取回)
retain |  vt. 保持, 保留; 记住
disqualify |  vt. 使...丧失资格
mechanism |  n. 机制,原理，机械,机构,结构
hive |  n. 蜂房, 蜂箱，蜂群，喧闹繁忙的场所 // vi.蜂进入蜂箱，聚居 // vt.使蜂入箱，储备
honey |  adj. 蜂蜜似的,深爱的 // n. (复数)蜂蜜,宝贝,爱人 // vt. 加蜜使甜,对...说甜言蜜语 // vi. 说甜言蜜语,奉承
beeswax |  n. 蜂蜡
drone |  n. 雄蜂, 游手好闲者, 嗡嗡声，无人驾驶飞机（或艇等），单调的低音 // vi. 发出嗡嗡的声音, 混日子 // vt. 单调低沉地说，过着单调无聊的日子
worker bee |  工蜂
offspring |  n. 子孙, 后代, 产物
combustion |  n. 燃烧
immune |  adj. 免除的,免疫的 // n. 免疫者
resistant |  adj. 抵抗的,反抗的 // n. 抵抗者
invulnerable |  adj. 固若金汤的, 无法伤害的
susceptible |  n. 易受影响者,易受感染者 // adj. 易受影响的,易感动的,容许
liable |  adj. 有义务的,应负责的,有...倾向
violence |  n. 暴力,狂热
advocacy |  n. 拥护, 支持, 鼓吹
maintenance |  n. 维护, 保持, 维修, 生活费用 // n. 供给, 抚养; 主张
comb |  n. 梳子,梳状物,鸡冠,蜂巢 // vt. 梳理,清理,搜查,用梳子 // vi. 搜寻
spasm |  n. 抽筋, 痉挛，（动作，感情等的）一阵发作
integrate |  v. 整合, 使...成整体
integration |  n. 综合, 集成, 同化
distribution |  n. 分发, 分配, 散布, 分布
parallel |  adj. 平行的,相同的,类似的,并联的 // adv. 平行地 // n. 平行线(面),相似物,对比 // vt. 相比,相应,与...平行
longitude |  n. 经度
woof |  n. 纬线，织物 // n. （狗的）低吠声 // vi. 狗吠
horizon |  n. 地平线；视野；眼界
vertical |  adj. 垂直的,顶点的,纵向的 // n. 垂直物, 垂直的位置
enforce |  vt. 加强, 强迫, 执行
enforcement |  n. 厉行, 执行, 强制
enforceable |  adj. 可实施的
consumption |  n. 消费
disharmony |  n. 失调, 不一致, 不和谐
lethal |  adj. 致命的,毁灭性的,有效的 // n. 基因异常,致死基因
estimate |  n. 估计, 估价 // v. 估计, 估价, 评价
underestimate |  n. 低估 // v. 低估
estimation |  n. 判断, 估计, 尊重
overestimate |  vt. 过高评价, 过高出价 // n. 估计过高, 评价过高, 出价过高
stainless |  adj. 无瑕疵的, 不锈的
annoy |  vt. &vi. 使...苦恼,骚扰, 使生气
annoying |  adj. 恼人的,讨厌的
annoyance |  n. 烦恼, 生气, 令人讨厌的人或事情
annoyed |  adj. 烦闷的
cereal |  adj. 谷类(的),谷物(的) // n. 谷类食物
glide |  n. 滑动, 滑过, 流水 // v. 滑动, 滑翔, 溜走
glider |  n. 滑翔机，助滑器，滑翔导弹
gliding |  v. 滑翔 // adj. 滑动的
slide |  n. 滑,幻灯片,雪崩,山崩,滑坡,滑梯 // vt. 使滑 // vi. 滑,跌落
slip |  vi.滑，滑脱； 犯过失，出错； （时间）不知不觉地过去； （健康状况等）变差 // vt.使顺利滑动； 摆脱； 放松，松开 // n.跌倒，失足； 纸条； 失误，口误； 事故 // adj.滑动的； 可拆卸的； 打有活结的
fault |  n. 故障,过失,缺点 // vt.&vi. 挑剔,指责，发现错误, 断裂
commitment |  n. 委托,实行,承诺,保证(律）拘禁令，奉献，献身
aborigine |  n. 土著居民
allergy |  n. 敏感症,反感,厌恶
athletics |  n. 体育运动，田径
breeding |  n. 生养，教养，抚养，繁殖，血统，育种 // breed的现在分词
bushfire |  n. 林区大火
carnivore |  n. 食肉动物
circulatory |  adj. 循环的，循环系统的
claw |  n. 爪,钳,螯,爪状物 // vt. &vi. 抓,撕
consultation |  n. 请教,谘询,协议会
contamination |  n. 污染,污染物
coronary |  adj. 冠状的, 冠状动脉或静脉的，心脏的 // n.冠状动脉或静脉，冠状动脉血栓形成，心脏病发作
corpulence |  n. 肥胖, 臃肿
cub |  n. 幼兽, 年轻人
deadly |  adj. 致命的, 致死的 // adv. 非常地, 如死一般地
dieter |  n. 节食者
digestion |  n. 消化, 吸收，领悟 // [生]细菌分解
digestive |  adj. 消化的，有助消化的 // n. 消化药
disability |  n. 无力, 无能, 残疾
eucalyptus |  n. 桉树
expectancy |  n. 期待(公算)
feral |  adj. 野生的,凶猛的
fibrous |  adj. 纤维的, 纤维性的
forelimb |  n. 前肢, 上肢
forestry |  n. 林产, 森林地
fruitarian |  n. 常食水果的人，果食主义者
gum |  n. 树胶,橡皮(糖),齿龈,粘性物质,牙床 // vt. 搞砸,用牙床嚼,以树胶粘合 // vi. 形成胶质,发粘
herbivorous |  adj. 食草的
heredity |  n. 遗传, 传统, 遗传特征
heroin |  n. 海洛因
hormone |  n. 荷尔蒙, 激素
hypertension |  n. 高血压, 过度紧张
inactivity |  n. 不活动, 迟钝
inbreeding |  n. 同系繁殖, 近亲交配 // 动词inbreed的现在分词形式
incidence |  n. 发生(率),入射
incisor |  n. 门牙
insomnia |  n. 失眠(症)
joey |  n. 幼兽(尤指幼袋鼠)
jogging |  n. 慢跑
junk |  n. 垃圾,废旧杂物,中国平底帆船 // vt. 丢弃
koala |  n. 考拉，树袋熊
mammal |  n. 哺乳动物
medication |  n. 药物治疗, 药物处理, 医药
metabolism |  n. 新陈代谢
migratory |  adj. 迁移的, 流浪的
monodrama |  n. 独角戏
morally |  adv. 道德上地，道义上地
mortality |  n. 必死的命运,死亡数目,死亡率
nocturnal |  adj. 夜的 // n. 夜间时刻测定器
offender |  n. 罪犯, 冒犯者
palm |  n. 手掌, 棕榈树 // vt. 把...藏于手中, 用手掌击(球)
pediatrician |  n. 小儿科医师,
pelt |  n. 皮毛，投掷, 疾行 // vt. 剥去皮毛，（连续）投掷 // vi. 猛击，大步走
perpetrate |  vt. 做（坏事）, 犯(罪)
perpetrator |  n. 犯人, 作恶之人
physique |  n. 体格，体形
plague |  n. 瘟疫, 麻烦, 灾祸 // vt. 折磨, 烦扰, 造成麻烦
pneumonia |  n. 肺炎
pouch |  n. 小袋,小包,囊状袋 // vt. 装...入袋中, 用袋运输 // vi. 用袋送信件
pregnancy |  n. 怀孕
prevention |  n. 阻止, 妨碍, 预防
proper |  adj. 适当的,正确的,合适的,正当的,规矩的
protest |  n. 抗议, 反对, 抗议书 // vi. 反对,抗议,断言 // vt. 坚持地表示, 对...提出异议
punishment |  n. 惩罚
python |  n. 丹舌,大蟒,巨蟒
Queensland |  n. 昆士兰州(澳大利亚)
rationalization |  n. 合理化
relaxation |  n. 松弛,放松,减轻
respiratory |  adj. 呼吸的
retaliate |  v. 报复, 报仇, 回敬
risky |  adj. 危险的(冒险的, 大胆的)
robbery |  n. 抢劫
sensitivity |  n. 敏感, 多愁善感, 感受性
shin |  n. 胫骨 // v. 攀爬, 快步走，踢或打在…的胫骨上
spoiled |  adj. 宠坏的 // 动词spoil的过去式和过去分词形式
stamina |  n. 持久力;耐力;毅力
territorial |  adj. 领土的, 土地的, 地方的 // n. 地方自卫队的士兵
theft |  n. 偷窃
trustful |  adj. 相信的, 信任的
unwed |  adj. 未婚的
upbringing |  n. 教养
vengeance |  n. 报复, 报仇, 复仇
yoga |  n. 瑜珈
coverage |  n. 涉及范围(如保险范围或储备金额)，涂层，新闻覆盖率
headline |  n. (pl.)新闻提要, 大字标题
front page |  头版,重要的
journalist |  n. 记者, 新闻工作者
mass media |  n. 大众传播媒体，海量媒体数据，新闻界
press conference |  记者招待会
news broadcast |  新闻广播
severe |  adj. 剧烈的, 严重的, 严峻的, 严厉的, 严格的
severity |  n. 严格, 严重, 激烈
concentration |  n. 集中, 专心, 浓度
deposit |  vt. 存放, 堆积, 使沉淀 // vi. 沉淀 // n. 存款, 定金, 堆积物
deposition |  n. 沉积作用(沉积物, 矿床)； <律>(在法庭上的)宣誓作证;证词,证言
depositor |  n. 寄托者,存款人
depository |  n. 存储处, 贮藏所, 受托者
priority |  n. 优先权, 优先顺序, 优先
suffer |  vt. 遭受,忍受,允许 // vi. 忍受,经历
envisage |  vt. 想像，设想; 正视，面对; 观察，展望
solar |  adj. 太阳的,太阳能的
bubble |  n. 泡沫, 气泡, 幻想, 骗局, 欢乐 // vi. 起泡, 出现, 洋溢 // vt. 使冒泡
abandon |  n. 放纵 // vt. 放弃,遗弃,沉溺
abandoned |  adj. 被抛弃的,无约束的
abandonment |  n. 放弃, 自暴自弃, 放纵
conviction |  n. 定罪, 信服, 坚信
dynamic |  adj. 动态的, (有)动力的, (有)力的; 有活力的 // n. 动力; 力学
diagnose |  v. 诊断 // vi. 判断,诊断(疾病) // vt. 诊断(疾病)
diagnosis |  n. 诊断
symptom |  n. 症状, 征兆
clinic |  n. 诊所,门诊部,科室
allergy |  n. 敏感症,反感,厌恶
antibiotic |  adj. 抗菌的 // n. 抗生素
case history |  n. 病历，个人历史
thrive |  vi. 兴旺,繁荣
distinct |  adj. (from)独特的,不同的,明显的,清楚的
license |  n. 批准,许可证,特许 // vt. 允许,特许
methane |  n. 甲烷
restrict |  v. 限制,约束
disclose |  vt. 揭露
inhabitant |  n. 居民
dormant |  adj. 睡眠状态的, 静止的 // [计算机] 静止的
illusion |  n. 幻觉,错觉,错误的信仰(或观念)
spine |  n. 背骨, 脊柱, 尖刺
association |  n. 联合,结合,交往,协会,社团,联想
conversion |  n. 转变, 改变信仰, 换位
attempt |  vt.试图； 尝试 // n.进攻； 尝试，冲击
humidity |  n. 湿度, 湿气
transparent |  adj. 透明的, 明显的, 清晰的
brand |  n. 燃烧的木条,剑,商标,牌子,烙印,类型 // vt. 打烙印,污蔑,铭记
justify |  vt. 替...辩护,证明...正当 // n. 对齐 // [计算机] 调整
intense |  adj. 非常的,强烈的,紧张的,热情的
expectation |  n. 期待,期望 // v. 期待,前程
scare |  vt. 惊吓(惊恐,惊慌) // vi. 受惊吓 // n. 惊吓(惊恐,惊慌)
disturb |  vt. &vi. 扰乱,妨碍,使...不安
foresee |  v. 预见, 预知
acute |  adj.尖的，锐的； 敏锐的，敏感的； 严重的，剧烈的； [医]急性的, 激烈的, 尖锐的
agribusiness |  n. 农业综合企业
alga |  n. 海藻，水藻
anchovy |  n. 凤尾鱼
angler |  n. 钓鱼者，琵琶鱼
aquaculture |  n. 水产业, 水产养殖
aquatic |  n. 水生动物, 水草 // adj. 水生的, 水中的, 水上的
auditory |  adj. 听觉的 // n. 观众，观众席
bait |  n. 饵,引诱 // vt. 嘲笑,纵犬攻击,以饵引诱,放饵
baleen |  n. 鲸须
blowhole |  n. 喷水孔, 通风孔, 通气孔
blubber |  n. 鲸脂，鲸油；啜泣，哽咽  vt. 哭诉  vi. 哽咽  a. 肿大的，肥厚
bowhead |  n.【动物】弓头鲸,北极露脊鲸
buzz |  n. 嗡嗡声 // vi. 发出嗡嗡声,充满,匆忙 // vt. 飞进,使嗡嗡叫
cavity |  n. 洞, 空穴, 腔
cetacean |  adj. 鲸的, 鲸类的 // n. 鲸目生物
chum |  n. 密友, 室友 // n. 鱼饵 // vi. 结为密友 // v. 用鱼饵钓鱼
climatic |  adj. 气候上的
cod |  n. 鳕鱼 // v. 哄骗, 愚弄
compass |  n. 指南针,圆规 // vt. 图谋,包围,达成
dorado |  n. 剑鱼, 旗鱼
downstream |  adv. 下游地 // adj. 下游的
echolocation |  n. 回声定位法
entangle |  vt. 使...纠缠, 使...复杂，卷入, 使...混乱
estuary |  n. 河口, 江口
fishery |  n. 渔场(渔业)
frequency |  n.&amp;adj. 频繁,频率
geomagnetic |  adj. 地磁气的
hatchery |  n. 孵卵所
headwater |  n. 上游(河源)
humpback |  n. 驼背, 座头鲸, 小鲑鱼
logging |  n. 砍伐 // 动词log的现在分词
migration |  n. 移民,移往,移动
olfactory |  adj. 嗅觉的
predation |  掠夺行为
restoration |  n. 恢复, 归还, 复位
riparian |  adj. 河岸的, 生于河岸的
sac |  n. 囊, 液囊
salmon |  adj. 橙红色的 // n. 鲑,大马哈鱼
salvation |  n. 得救,拯救,赎罪
sardine |  n. 沙丁鱼
sedimentation |  n. 沉淀，沉降
spawn |  n. 卵,产物,后代,结果 // vt. 产卵,种菌丝于,产生,造成 // vi. 产卵,大量生产
topography |  n. 地志, 地形学, 地势，剖析图
trout |  n. 鳟鱼，鳟鱼肉
upstream |  adj. 逆流而上的 // adv. 向上游, 逆流地
vernacular |  n. 本地话, 方言，（动植物的）俗名 // adj. 地方的, 地方语的，白话的
feedback |  n. 反馈,成果
postgraduate |  n. 研究生 // adj. 大学毕业后的
skeptical |  adj. 怀疑的
censor |  n. 检查员, 潜意识的抑制,为Freud学派的术语 // v. 检查
eruption |  n. 爆发,喷发，出疹，长牙
toxin |  n. 毒素, 毒质
alienation |  n. 疏远,离间,让渡,[哲]异化
deplete |  vt. 耗尽,使...空竭
depletion |  n. 消耗,罄尽,放血
addition |  n. 增加,附加物,加,加法
sulphuric acid |  n. 硫酸
dome |  n. 圆屋顶
grip |  n.  紧握,了解,手柄,手提包 // vt. 紧抓,吸引
minority |  n. 少数, 少数民族, 未成年
linguistic |  adj. 语言的, 语言学的
supply |  n. 补给,供给,供应，贮备 // vt. 补给,供给,提供,提供足够以满足
costume |  n. 服装,剧装 // vt. 提供服装, 为...设计服装 // adj. 服装打扮的
monitor |  n. 监督器, 班长, 监听员, [计算机]显示器, 监视器 // v. 监视, 监听, 监督
ignorant |  adj. 不知道的, 无知的, 愚昧的
ignorance |  n. 无知
scope |  n. 能力，范围，眼界，机会，余地 // vt. 仔细研究
tropical |  adj. 热带的, 炎热的, 热带植物的
entitle |  v. 取名为,给与名称,叫做,使有权利
exclusively |  adv. 排他地(独占地,专门地,仅仅,只)
compete |  v. 竞争, 对抗
enrolment |  n. 登记,招收，入学
comment |  n. 注释, 评论; 闲话 // v. 注释, 评论
digest |  n. 摘要 // vt. 消化,理解 // vi. 消化
accessible |  adj. 可得到的, 易接近的, 可进入的
crisis |  n. 危急关头,危机
device |  n. 装置, 设计, 策略, 设备
essential |  adj.基本的； 必要的； 本质的； 精华的 // n.必需品； 基本要素； 必不可少的东西
competent |  adj. 有能力的,胜任的,足够的
sufficient |  adj. 足够的, 充分的
inefficient |  adj. 无效率的, 无能的，不称职的
draft |  n. 草稿,草图,汇票，徵兵 // vt. 起草,征兵,选秀 // adj. 酝酿中的
longitudinal |  adj. 经线的, 纵向的, 长久的
uniform |  adj. 一致的,统一的 // n. 制服 // vt. 穿制服
link |  n. 环节,联系, (链的)环, 圈 // vt. &vi. 连接,联系
urge |  n. 冲动 // vt. 驱策,鼓励,力陈,催促 // vi. 极力主张
career |  n. 生涯, 职业, 事业 // vi. 猛冲, 飞跑 // vt. 在...中急行
aerodynamics |  n. 空气动力学,气体力学
aeronautical |  adj. 航空的，航空导航用的
aggregation |  n. 集合, 聚合, 集合体
anterior |  adj.前面的，前部的，较早的
apiculture |  n. 养蜂业
appendage |  n. 附加物, 附属肢体
arthropod |  n. 节肢动物 // adj. 节肢动物的
biomechanics |  n. 生物力学
crustacean |  n. 甲壳类动物 // adj. 甲壳纲的
cypress |  n. 丝柏, 丝柏木
diapause |  n. [生]滞育(昆虫生长的停滞期), 间歇期
dorsal |  adj. (动物）背的, 背部的, 背侧的 // =dossal
drosophila |  n. 果蝇
embryology |  n. 胚胎学，发生学
epithelial |  adj. 上皮的
exoskeleton |  n. [动]外骨骼，皮骨骼
fir |  n. 枞树, 枞木
gill |  n. 鳃, 及耳(液量单位） // vt. 用刺网捕鱼 // vi. 被缠在刺网中
gradient |  n. 倾斜度,坡度,升降率 // adj. 倾斜的,步行的,步行态的
horsefly |  n. 马蝇
hover |  vi. 盘旋,翱翔,徘徊 // n. 盘旋,翱翔,徘徊
imbibe |  v. 饮, 吸取, 吸入
inhospitable |  adj. 不好客的，不适于居住的
larval |  adj. 幼虫的, 幼虫状态的
manatee |  n. 海牛
market value |  n. [商](有别于帐面价值的)市场价值，市价
mating |  n.交配  // 动词mate的现在分词
monarch |  n. 帝王, 统治者, 元首/nn. 君王斑点蝶
morphology |  n. 形态学，语形论，形态论
nectar |  n. 花蜜, 甜美的饮料，众神饮用的酒
paleontology |  n. 古生物学
propeller |  n. 螺旋桨, 推进器 // =propellor
pupa |  n. 蛹
ranch |  n. 牧场
reproductive organ |  生殖器
skeleton |  n. 骨架,纲要,骨骼,骨瘦如柴的人或动物,家丑 // adj. 骨骼的
suspension |  n. 悬挂,悬浮液,暂缓,未决,中止
taste bud |  n. 味蕾
taxon |  n. [生]分类单元
terrestrial |  adj. 地球的；陆地的，[生物] 陆生的；人间的 // n. 陆地生物；地球上的人
trawler |  n. 拖捞船, 拖网捕鱼者
tropical rainforest |  热带雨林
tuna |  n. 金枪鱼
underbrush |  n. 矮树丛
ventral |  adj. 腹部的
walrus |  n. 海象
wingspan |  n. 翼幅，翼展
poison |  n. 毒药,败坏道德之事,毒害 // vt. 毒害,摧毁,中毒 // adj. 有毒的
spectrum |  n. 光谱, （比喻）范围, 系列
immigrant |  n. 移民, 侨民 // adj. 移民的
release |  n. 释放, 让渡, 发行 // vt. 释放, 让与, 准予发表, 发射
accomplish |  vt. 完成
ecosystem |  n. 生态系统
sincere |  adj. 真诚的, 诚挚的
environment |  n. 环境,外界
ideal |  adj. 理想的, 完美的, 高尚的 // n. 理想, 典范, 目标
comprise |  vt. 包含,构成
anecdotal |  adj. 逸话的, 多逸事趣闻的, 轶事一样的
blame |  n. 过失,责备 // vt.把...归咎于,责备
vertebrate |  adj. 脊椎的，脊椎动物的 // n. 脊椎动物
privacy |  n. 隐私, 隐居, 秘密
allocate |  v. 分派, 分配, 分配额
antiquity |  n. 高龄, 古老, 古物, 古迹
cosset |  n. 亲手饲养的小动物,宠儿 // v. 宠爱,珍爱,溺爱
interact |  vi. 相互作用,相互影响
emit |  v. 发出,放射,吐露 // [计算机] 发射
astray |  adv. 迷途地 // adj. 迷途的, 误入歧途的
sensible |  adj. 可察觉的,意识到的,实用的 // n. 可感知物
duration |  n. 持续时间，期间
medium |  n. 媒体, 方法, 媒介 // adj. 适中的, 中等的
explore |  vt. &vi. 探险,探测,探究
specialty |  n. 专门,特别,特性,特产
inject |  v. 注射
mission |  n. 任务,代表团,使命,传教 // vt. 传教 // [计算机] 使命
photography |  n. 摄影术
lateral |  adj. 侧面的,横向的,旁边的 // n. 分流,后传,后音 // vi. 完成横向穿越
division |  n. 区分,分开,除法,公司,部门，师（军队里）
contemporary |  n. 同时代的人；同时期的东西 // adj. 当代的；同时代的；属于同一时期的
recommend |  vt. 建议, 推荐, 劝告 // vt. 使成为可取, 使受欢迎
clay |  n. 粘土,泥土
develop |  vt. 发展,开发,冲洗照片 // vi. 进步
latitude |  n. 纬度，界限,自由选择权
cruise |  n. 巡航,巡弋,漫游 // vi. 乘船游览,慢速行驶,巡行,猎艳 // vt. 巡游,猎艳
property |  n. 财产; 性质; 道具
aerodynamic |  adj. 空气动力的(气动的)
alphabet |  n. 字母表,基本原理(元素)，符号系统
anticoagulant |  adj. 抗凝的
antivenin |  抗蛇毒素 // 抗动物毒血清 // 抗蛇毒血清
baboon |  n. 狒狒
belly |  n. 腹部 // v. 膨胀
boa |  n. 蟒蛇，女用毛皮, 羽毛围巾
calibrate |  v. 测定口径, 查看刻度, 划刻度 校正
capybara |  n. [动]水豚(产于南美湖泊溪流间的啮齿动物)
charmer |  n. 魔术师，迷人的人
chimp |  n. (非洲)黑猩猩
cobra |  n. 眼镜蛇
concept |  n. 概念, 观念
constrictor |  n. 括约肌，大蟒，压缩物，压缩器
copperhead |  n. 铜斑蛇，南北战争时同情南方的北方人
dialysis |  n. 透析
envenom |  vt. 下毒, 使恶毒
epinephrine |  n. [生化]肾上腺素
ethnology |  n. 人种学，社会人类学
genotype |  n. 基因型，遗传型
geometric |  adj. 几何学的, 几何学上的, 几何学图形的
gorilla |  n. 大猩猩
grub |  n. [动]蛆，苦工 // n. &lt;非正式&gt;食物 // vt. 挖掘，翻掘 // vi. 挖掘，搜寻，做苦工
hippocampus |  n. （希腊神化中的）马头鱼尾的怪兽 // n. 海马，[解剖]（脑内的)海马状突起
hormonal |  adj. 荷尔蒙的, 激素的
hypotension |  n. 低血压
inheritance |  n. 遗传,遗产,继承,继承物
intravenous |  adj. 静脉的，静脉注射的
invertebrate |  n.&amp;adj. 无脊椎的(动物)
itch |  n. 痒, 渴望, 疥癣 // v. 使...痒, 渴望
laceration |  n. 撕裂, 裂口，锯齿状的伤口
linguist |  n. 语言学家
macaque |  n. 短尾猿，猕猴
navigational |  adj. 导航的，航行的
navigator |  n. 航海家，领航员
neurological |  adj. 神经病学的
neuromuscular |  adj.神经肌肉的
neurotoxic |  adj. 毒害神经的
numerical |  adj. 数字的, 用数字表示的
nutcracker |  n. 胡桃钳子 // n. 星鸟类
orangutan |  n. 猩猩
paralysis |  n. 瘫痪
parrot |  n. 鹦鹉, 盲目重复或模仿他人行为的人 // vt. 学舌, 盲目重复或模仿
pigeon |  n. 鸽子
plover |  n. 珩科鸟
polar light |  极光 // 偏光
poultry |  n. 家禽
prism |  n. 棱柱,棱镜，折光体
propolis |  n. 蜂胶
puzzle |  n. 难题,迷惑 // vt. 使困惑,解决 // vi. 迷惑,苦思
rattlesnake |  n. 响尾蛇
raven |  n. 大乌鸦 // adj. 乌黑的 // v. 掠夺
reptile |  adj. 爬虫类的 // n. 爬行动物
rhombus |  n. 菱形, 斜方形
rodent |  n. 啮齿动物 // adj. 啮齿目的
royal |  adj. 王室的,盛大的,极度的 // n. 贵族,顶帆
scout |  n. 童子军,侦察员, 守卫 // vt. 侦察, 物色人才 // vi. 寻找, 物色
shutdown |  n. 关机，停工
snakebite |  n. 蛇咬伤
sparrow |  n. 麻雀
swarm |  vi. 挤满；成群浮游；云集 // n. 蜂群；一大群 // vt. 挤满；爬
trauma |  n. 精神创伤,外伤
untangle |  vt. 解开纠结, 解开, 排解
venom |  n. 毒液,恶意
viper |  n. 毒蛇,毒蛇一样的家伙,阴险人 // 毒品
wingtip |  n. 翼尖
vegetarian |  n. 素食者 // adj. 素食的
recipe |  n. 食谱,处方,秘诀
adopt |  v. 采用, 收养, 接受
throughout |  adv. 到处, 自始至终 // prep. 遍及, 贯穿
optimism |  n.&amp;adj. 乐观,乐观主义
guilty |  adj. 有罪的, 内疚的
embrace |  n. 拥抱 // v. 拥抱,互相拥抱,包含
portable |  adj. 轻便的,手提式的 // n. 手提打字机
detrimental |  adj. 有害的 // n. 有害的人或事
upset |  adj. 心烦的 // vt. 加厚,推翻,扰乱 // vi. 推翻 // n. 推翻,混乱
tedious |  adj. 沉闷的, 单调乏味的
sinister |  adj. 不吉利的, 凶恶的, 左边的
sophisticated |  adj. 复杂的；精致的；久经世故的；富有经验的 // v. 使变得世故；使迷惑；篡改（sophisticate的过去分词形式）
maximum |  n. 极点, 最大量, 极大 // adj. 最高的, 最大极限的
inflammable |  adj. 易燃的, 易怒的 // n. 易燃物
convenience |  n. 适宜，便利, 便利设施，方便的时间，舒适
sensitive |  adj. 敏感的,灵敏的,易受伤害的,感光的,善解人意的  // n. 敏感的人
lava |  n. 熔岩, 火山岩
avoid |  v. 避免 // vt. 避免,逃避
confusion |  n. 混乱,混淆,不确定状态
bulletin |  n. 公示,公报,新闻快报,期刊 // vt. 发表,用公告通知
hatch |  n. 孵化,舱口 // vt. 孵,孵出 // vi. 孵化，破壳
discourage |  vt. 使气馁,阻碍
commercial |  adj. 商业的 // n. 商业广告
cube |  n. 立方体,立方 // vt. 求...的立方 // adj. 立方的
sprawl |  vi. 蔓延；伸开手足躺；无计划地扩展 // vt. 懒散地伸开；使蔓生 // n. 蔓生；伸开手足躺卧姿势
organism |  n. 生物体, 有机体
pervious |  adj. 可渗透的，能接受的，能理解的
stance |  n. 立场；姿态；位置；准备击球姿势
dash |  n. 冲撞,破折号,少量,短跑,冲劲 // vt. 猛掷,泼溅,冲撞,匆忙 // vi. 猛冲,猛撞
accessory |  adj. 附属的(副的,辅助的) // n. 附件，同谋
hollow |  n. 洞, 窟窿, 山谷 // adj. 空的, 虚伪的, 空腹的 // vt. 形成空洞, 挖空 // vi. 形成空洞 // adv. 有闷哑声, 完全地
uneasy |  adj. 不自在的, 心神不安的, 不稳定的, 不舒服的
remarkable |  adj. 显著的, 异常的, 非凡的, 值得注意的
force |  n. 力量,武力,暴力,影响力 // vt. 施暴,强迫,强夺,加压力 // [计算机] 强制
illustrate |  vt. 举例说明,作图解 // vi. 举例
timber |  n. 木材,木料
artery |  n. 动脉, 主流, 干道
Arctic |  adj. 北极的,极寒的 // n. （首字母大写时）北极圈,北极地方
bedrock |  n. 岩床, 根底, 基础
Celsius |  adj. 摄氏的
changeable |  adj. 易变的，可改变的
chaotic |  adj. 混沌的；混乱的，无秩序的
climatologist |  n. 气象学家
concentrate |  vt.& vi.专心于； 注意； 集中； 聚集 // vt.浓缩，（使）浓缩； [采矿]汰选； 选矿，精选，富集 // vi.凝缩，浓缩，提纯 // n.浓缩物 // adj.集中起来的，经过浓缩的
cracking |  n. 分裂, 分解 // adj. 很快的, 很好的, 很美的 // adv. 很快地, 很好地, 很美地
crust |  n. 外壳,坚硬的外壳,面包皮 // vt. 盖以硬皮 // vi. 结硬皮
crustal |  adj. 地壳的，外壳的
deformation |  n. 变形，畸形
detectable |  adj. 可发现的(可察觉的,可探测出的,可检波的)
distortion |  n. 扭曲, 变形, 曲解
drift |  n. 漂移,漂流物,观望,漂流,吹积物,趋势 // vi. 漂移,漂流,吹积 // vt. 使漂流,把...吹积
dynamics |  n. 力学,力量,力量变化
electrical |  adj. 电的,电气科学的
fabric |  n. 织物, 布, 结构
federal |  adj. 联邦的 // n. 同盟盟友
fluctuation |  n. 波动,起伏
foreshock |  n. （地震的）前震
freeze |  v. 冻结, 冷冻, 僵硬 // [计算机] 冻结
geological |  adj. 地质学的 // =geologic
geophysical |  adj. 地球物理学的
geophysicist |  n. 地球物理学者
glacier |  n. 冰河, 冰川
hydraulic |  adj. 水力的, 水压的
immobilize |  v. 使不能动 // vt. 使不动, 使固定
inconclusive |  adj. 非决定性,不确定的,不得要领的
landslide |  n. 山崩 // n. (竞选中)压倒多数的选票
micro |  adj. 微小的 // n. 微米(百万分之一, 测微计)
moisture |  n. 潮湿,湿气
monsoon |  n. 季节风,吹季节风的季节,雨季
observatory |  n. 天文台；气象台；瞭望台
partial |  adj. 部分的,偏袒的,偏爱的 // n. 泛音
penguin |  n. 企鹅
polar |  adj. 两极的,南辕北辙的,极地的 // n. 极线,极性
prediction |  n. 预言, 预报
psychiatry |  n. 精神病学
psychologist |  n. 心理学家
psychology |  n. 心理学
radioactive |  adj. 放射性的
recognizable |  adj. 可认识的, 可承认的, 可辨别的
response |  n. 反应, 响应; 回答
rhesus |  n. 恒河猴 // =rhesus monkey
rift |  n. 裂口, 隙缝, 切口 // v. 裂开, 割开，渗入
rupture |  n. 破裂, 断裂 // v. 使破裂
scale |  n. 鳞, 刻度, 衡量, 数值范围 // v. 依比例决定, 攀登
seismic |  adj. 地震的
seismogram |  n. 震动图
seismograph |  n. 地震计
seismology |  n. 地震学
seismometer |  n. 地震仪
sensor |  n. 传感器，探测器
simulation |  n. 模拟,仿真,赝品
slippage |  n. 滑移，滑动，动力传动损耗
structural |  adj. 结构的, 构造的，建筑的，建筑用的
tectonics |  n. 筑造学, 构造学, 构造地质学
tsunami |  n. 海啸
twilight |  n. 黄昏,微光,略知 // v. 使微明
vibration |  n. 震动, 颤动
volcanism |  n. 火山作用, 火山现象
zone |  n. 地域,地带,地区 // vt. 划分成带, 标出或指定成区, 用腰带围绕 // adj. 地区性的, 地域上的
incendiary |  adj. 放火的, 煽动的, 教唆的 // n. 纵火犯人, 煽动者, 燃烧弹
spectacular |  adj. 壮观的, 令人惊叹的 // n. 惊人之举, 壮观的表演或影视作品
exacerbate |  vt. 加重(使...恶化, 激怒)
cable |  n. 电缆,海底电报 // vt. 打海底电报,把...拧成缆,用缆捆住 // vi. 打海底电报
minimize |  v. 将...减到最少 // [计算机] 最小化
muscle |  n. 肌肉 // vt. 用力挤 // vi. 用力进行
excessive |  adj. 过多的,过分的
turbine |  n. 涡轮
personality |  n. 个性, 名人, 特色
domestic |  adj. 国内的, 家庭的, 驯养的 // n. 家仆, 佣人
assess |  v. 估定, 评定
breakthrough |  n. 突破
revise |  n. 校订, 修正, 再校稿 // v. 校订, 修正, 校正
virus |  n. 病毒, 毒素, 有害的事物
beam |  n. 光线，电波，横梁，容光焕发 // vt. 发出（光、电、热、信号）；为……上梁 // vi. 微笑；发光
hazard |  n. 冒险,危险,危害 // v. 冒...的危险,赌运气
confront |  vt. 面临, 对抗, 遭遇
stout |  n. 烈啤酒 // adj. 强壮的, 稳重的, 肥胖的
disregard |  n. 不理会, 漠视 // vt. 忽视, 不顾
assimilate |  v. 使同化，吸收 // n. 被同化的事物
ecology |  n. 生态学
automatically |  adj. 不经思索的 // adv. 自动地
exceed |  vt. 超过, 胜过, 超出界限 // vi. 领先
arithmetic |  n. 算术
enthusiasm |  n. 热心，热忱，热情
rival |  n.对手； 竞争者 // vt.与…竞争； 比得上某人 // vi.竞争 // adj.竞争的
harridan |  n. 形容枯槁(或脾气暴躁)的老妇人, 名声不好的老泼妇
engage |  v. 答应, 预定, 使忙碌, 雇佣, 订婚
extracurricular |  adj. 课外的
bacterial |  adj. 细菌的
extend |  v. 扩充, 延伸, 伸展, 扩展
hostile |  adj. 怀敌意的,敌对的
fragile |  adj. 易碎的,脆的,精细的
promising |  adj. 有希望的,有前途的
numerous |  adj. 为数众多的,许多
vacuum |  n. 真空,空间,真空吸尘器 // adj. 真空的,产生(利用)真空的 // vt. &vi. 用吸尘器打扫
accumulation |  n. 积聚, 累积, 积聚物
bomb |  n. 炸弹,高压罐,火山口喷出的熔岩 // vt. 轰炸,大败,长传 // vi. 失败
buffer |  n. 缓冲,缓冲区 // vt. 减轻,缓冲
caldera |  n. 火山口
canopy |  n. 天篷, 遮篷, 苍穹
carving |  n. 雕刻品, 雕刻, 雕刻术 // 动词carve的现在分词
cinchona |  n. 金鸡纳树, 金鸡纳树皮
cinder |  n. 煤渣, 灰烬
coastal |  adj. 海岸的,沿海的,沿岸的
coastline |  n. 海岸线
composite |  adj. 合成的,复合的 // n. 合成物, 复合材料 // vt. 合成
cone |  n. 圆锥体,锥形物,球果 // vt. 变成锥形,削尖
conical |  adj. 圆锥体的
crystal |  adj. 清澈透明的, 晶体的 // n. 水晶, 结晶
crystalline |  adj. 水晶(般)的, 水晶做的，透明的
dengue |  n. 骨痛热
domical |  adj. 圆屋顶的, 圆顶式结构的
dormancy |  n. 休眠，冬眠，潜伏
dune |  n. 沙丘
fissure |  n. 裂缝,裂沟 // v. 裂开,分裂,裂成缝
fluid |  adj. 流畅优美的,流体的,流动的,不稳定的 // n. 流体,液体
foliage |  n. 叶子(总称)，簇叶
geologic |  adj. 地质的
geologist |  n. 地质学家
icecap |  n. (高山等上之)常积不消的冰, 冰盖 // =ice cap
igneous |  adj. 火的, 似火的, [地质]火成的
incandescent |  adj. 光亮的, 发白热光的, 白热化的 // n. 白炽灯泡
lava dome |  熔岩穹丘
layer |  n.层，层次； 膜； [植]压条； 放置者，计划者 // vt.把…分层堆放； 借助压条法； 生根繁殖； 将（头发）剪成不同层次 // vi.形成或分成层次； [植]通过压条法而生根
malaria |  n. 疟疾
meteorologist |  n. 气象学家
molten |  adj. 熔化的,炽热的,铸造的 // vbl. 融化,溶解,变软
mosquito |  n. 蚊子
mudslide |  n. 泥流
nitrous |  adj. 含有三价氮的
normal |  adj. 正常的,正规的 // n. 常态, 标准
oblivion |  n. 遗忘, 忘却
oscillation |  n. 振动, 动摇, 彷徨，振幅，单一的振动循环
outbreak |  n. 爆发
pasty |  adj. 浆糊的, 苍白的 // n. 馅饼
permafrost |  n. 永久冻土层
plateau |  n. 高原;平稳;稳定状态 // vi. 到达平稳阶段
precipitate |  vt. 使...陷入,促成,使...沉淀, 猛摔 // n. 沉淀物, 冷凝物 // adj. 仓促的, 迅猛的, 感情用事的
pumice |  n. 浮石, 浮岩 // vt. 用浮石磨, 用轻石擦净
red tide |  红潮
remedial |  adj. 治疗的, 补救的, 矫正的
retreat |  n. 休息寓所,撤退,隐居 // vt. &vi. 撤退, 向后倾
runoff |  n. 决赛, 流走的东西, 径流
sandy |  adj. 沙的, 沙地的, 多沙的 //      沙色的 //      不稳固的
seashore |  n. 海岸, 海滨
seawall |  n. 海塘，护岸，海堤
sediment |  n. 沉淀物
shield |  n. 盾,防卫物,盾状物 // vt. 保护,遮蔽
socioeconomic |  adj. 社会经济的
stratospheric |  adj. 平流层的，同温层的，极高的
symmetrical |  adj. 对称的
tidal |  adj. 潮的, 有关潮水的
tornado |  n. 飓风,旋风,龙卷风
upwelling |  n. 喷出，上喷，上升流 // 动词upwell的现在分词形式
vent |  n. 排气口, 表达, 发泄, 火山口 // vt.&vi. 发泄, 表达, 排放
volcanic vent |  火山口
profitable |  adj. 有益的, 有用的
install |  v. 安装,安置,使...就职 // n.[计算机] 安装,DOS命令 : 装入结束且驻留软件
technical |  adj. 工艺的, 技术的
gear |  n. 齿轮,传动装置,设备,工具 // vt. &vi. 使适应于,以齿轮连起,配搭活动,调整
endeavour |  n. （尤指新的或艰苦的）努力，尝试; v. 努力；尽力；竭力
insurance |  n. 保险
poverty |  n. 贫穷,贫困
overcome |  vt. 战胜,克服,(感情等)压倒, 使受不了 // vi. 获胜, 赢
transform |  vt. 转换,变形 // vi. 改变 // n. 变形
aesthetic |  adj. 美学的,审美的,有美感的 // n. (复数)审美观
handicapped |  adj. 残疾的,有生理缺陷的
patent |  n. 专利权,执照,专利品 // adj. 专利的,显著的,新奇的 // v. 取得...的专利权,请准专利
decent |  adj. 有分寸的,得体的,相当好的
handle |  n. 柄,把手 // vt. 买卖,处理,操作 // vi. 驾驭
volcano |  n. 火山
correspond |  vi. 符合,通信,相当
encounter |  n. 意外的相见,遭遇 // vt. &vi. 遇到,偶然碰到,遭遇
distract |  vt. 转移,分心
deprive |  vt. 剥夺,拒绝,免职
mature |  adj. 成熟的, 到期的, 充分发育的, 考虑周到的 // vt. 使...成熟, 长成 // vi. 长成, 成熟; 到期
transcribe |  vt.（用不同的录音手段）转录； 抄写，誊写； 改编（乐曲）（以适应他种乐器或声部）
require |  v. 需要, 要求
layout |  n. 布局, 安排, 设计
identify |  vt.识别，认出； 确定； 使参与； 把…看成一样 // vi.确定； 认同
barrier |  n. 界线,屏障,障碍物 // v. 以屏障隔开
desert |  n. 沙漠,荒地,应得(的惩罚或奖励)adj. 沙漠的,荒凉的vt. 遗弃vi. 擅离职守
achievement |  n. 成就, 成绩, 完成, 达到
conventional |  adj. 普通的,常见的,习惯的,常规的
stabilize |  v. 使安定, 使坚固
stylish |  adj. 现代风格的, 流行的, 潇洒的
anatomy |  n. 解剖学, 解剖学专著，分解，解剖，骨骸
adjacent |  adj. 毗连的,邻近的,接近的
vital |  adj. 至关重要的, 生死攸关的, 有活力的, 充满生机的
multiply |  vt. 乘,增加 // vi. 扩大,繁衍,做乘法 // adv. 多样地,多重地
mate |  n. 配偶, 同事, 助手 // v. 使...配对, 交配, 使...一致, 结伴
minimum |  adj. 最低的, 最小的 // n. 最小量, 最低限度
anticyclone |  n.逆旋风,高气压圈
asphyxiate |  v. (使)窒息
atmospheric |  adj. 大气的，大气层的，制造气氛的
belch |  v. 打嗝, 喷出
catalyst |  n. 催化剂,刺激因素
clearing |  n. 清除, 结算，(森林中的)空地 // 动词clear的现在分词
condensation |  n. 浓缩, 浓缩物, 凝结
contaminant |  n. 杂质(污染物质,沾染物)
cropland |  n. 农田，植作物之农地
cuckoo |  n. 杜鹃, 布谷鸟，咕咕声 // n. 傻子，疯子 // vt. 发出咕咕声 // adj. 愚蠢的, 疯狂的
deforest |  vt. 采伐森林，清除树林
dwelling |  n. 住处；寓所 // v. 居住（dwell的现在分词）
engineering |  n. 工程(学),工程技术
epidemiology |  n. 传染病学，流行病学
epiphyte |  n. 附生植物
fatality |  n.(事故或战争等造成的)死亡, 灾祸, 天命，致命性
fauna |  n. （某地区或某时期的）所有动物
fern |  n. 羊齿植物，蕨
fluoride |  n. (护齿的)氟化物
fog |  n. 雾, 朦胧, 喷雾, 迷惑 // vt. &vi.以雾笼罩, 使模糊, 迷惑
foggy |  adj. 有雾的
foundry |  n. 铸造, 铸造场, 铸造类
fungus |  n. 真菌, 霉菌 // （复数为funguses或fungi)
generator |  n. 发电机, 发生器
geothermal |  adj. 地热的
girth |  n. 周围长度，带尺, 尺寸 // n.（马等的）肚带, 腰带 // vt. 量周长，包围，给…缚上肚带
grazing |  n. 放牧, 牧草 // 动词graze的现在分词
hardwood |  n. 硬木, 硬木材, 阔叶树 // adj. 硬木的，硬木制成的
hygroscopic |  adj. 易湿的, 吸湿的
insulating |  adj. 绝缘的 // 动词insulate的现在分词形式
irritation |  n. 刺激, 烦恼, 刺激物
kaka |  n.(新西兰产的)卡卡鹦鹉
lightning |  n. 闪电 // adj. 闪电般的, 快速的 // vi. 打闪
linoleum |  n. 油布, 油毯
mahogany |  n. 红木, 桃花心木
Maori |  n.&amp;adj. 毛利人(的)
mist |  n. 雾,迷蒙,朦胧不清 // vt. 使...模糊,蒙上雾 // vi. 使...模糊,下雾
morbidity |  n. 病态，发病率
noisome |  adj. 恶臭的, 令人不快的，有害的
parasite |  n. 寄生虫,寄生生物，食客
particulate |  n. 微粒子，微粒状物质 // adj. 微粒的
pasture |  n. 牧场 // v. 吃(草) // vt. 放牧
plank |  n. 厚板, 支撑物，政纲条目 // vt. 铺板, 用力放下
plantation |  n. 种植园，大农场，殖民地
premature |  adj. 早熟的,过早的,不按时的 // n. 早产儿,早发
pulp |  n. 果肉, 纸浆 // v. 化成纸浆, 除去...果肉, 制成纸浆
rainforest |  n. 雨林
resin |  n. 树脂,松香,树脂制品 // vt. 涂树脂
sanctuary |  n. 圣所, 耶路撒冷的神殿, 至圣所
sawmill |  n. 锯机, 锯木厂
scrubland |  n. 灌木丛林地
seafloor |  n. 海底
seedling |  n. 幼苗
shroud |  n. 寿衣, 覆盖物, [航海]船之横桅索 // v. 包以尸衣, 遮蔽, 隐藏，笼罩 // v. 掩盖，保护 // n.
shrub |  n. 灌木 // n. 果汁甜酒
smelter |  n. 熔炉，熔铸工人
smog |  n. 烟雾
soot |  n. 煤烟, 烟尘 // vt. 熏以煤烟
stoppage |  n. 停止，堵塞，停工
supernatural |  adj. 超自然的, 神奇的
swampland |  n. 沼泽地
tar |  n. 焦油,柏油 // n. 水手 // vt. 涂以焦油
thermal |  adj. 热的,热量的,保热的 // n. 上升的热气流
thunderbolt |  n. 雷电, 晴天霹雳，（突然且具毁灭性的猛烈行动的）人或物
thundercloud |  n. 雷雨云
toll |  n. 通行费,代价,伤亡人数,钟声 // vi. 征收通行税,鸣钟 // vt. 向某人征税,钟响,引诱
vaporize |  v.(使)蒸发 // =vaporise(英)
vapour |  n. 蒸气，水蒸气，雾气 // v. 蒸发，吹嘘 // =vapor（英）
vine |  n. 攀爬植物, 藤, 蔓
vineyard |  n. 葡萄园, 酿酒庄园
fleet |  n. 船队,舰队,团队 // vt. &vi. 飞过,掠过 // adj. 跑得快的
glue |  n. 胶,粘性之物 // vt. 粘, 紧附于...
denote |  vt. 象征,表示
expedition |  n. 远征,探险队,迅速
sponsor |  n. 保证人, 赞助者 // v. 发起, 赞助
alter |  v. 改变
subsequent |  adj. 随后的,后来的
trace |  n. 痕迹,踪迹,微量 // vt. 追踪,找出根源,描绘 // vi. 追踪
reinforce |  vt. 加强，加固；强化；补充 // vi. 求援；得到增援；给予更多的支持 // n. 加强；加固物；加固材料
intelligible |  adj. 可理解的, 易理解的, 明了的
revenue |  n. 总收入; 财政收入, 税收 // n. 税务局
capture |  n. 抓取,战利品,捕获之物 // vt. 抓取,获得,迷住
cinematography |  n. 电影术，电影摄影学
host |  n.[计算机]主机； 主人，东道主； 节目主持人； 酒店业主 // vt.当主人； 主办宴会，主持节目； 款待，做东 // vi.做主人，做东道主
flash |  n. 闪光,闪现,闪烁物,花哨,一瞬间,电脑动画技术 // vi. 闪现,闪烁 // vt. 传送,用光联络,流露出 // adj. 花哨的,炫耀的,昙花一现的
dominant |  adj. 占优势的，主导的，显性的 // n. 主宰者
encourage |  v. 鼓励,激励,支持 // vt. 鼓励
lever |  n. 杠杆,似杠杆之工具 // vt. 撬开,使用杠杆
elite |  n. 精华, 精锐, 中坚份子
consolation |  n. 安慰,令人安慰的事物
chemical |  adj. 化学的 // n. 化学制品
multiple |  adj. 许多,多种多样的 // n. 倍数,并联
waterproof |  adj. 防水的，耐水的 // n. 防水材料 // （英）雨衣 // vt. 使...能防水
demonstrate |  vt. 示范, 演示, 证明 // vi. 示威
stereo |  adj. 有立体视觉的,立体声的 // n. 固定形象,立体声
transport |  n.运输、运输工具；(常用复数）强烈的情绪、狂喜或狂怒 // vt. 运输；流放；为强烈的情绪所激动
subtle |  adj. 微妙的,敏感的,精细的,狡诈的,不明显的
temporary |  adj. 暂时的,临时的 // n. 临时工
interval |  n. 间隔,休息时间, (数学)区间, (音乐)音程
mantle |  n. 斗篷, 覆罩之物, 罩子 // v. 罩住, 覆盖, 脸红
bacteria |  n. (复数)细菌
bald |  adj. 秃头的,单调的 // vt. &vi. 使变秃头
biochemist |  n. 生物化学家
biodiversity |  n. 生物多样性
biotic |  adj. 生命的，生物的 // suf. 表示“生存方式”
boreal |  adj. 北的，北方的
Bulgaria |  n. 保加利亚（欧洲国名）
cattle |  n. 牛 // n. 家畜，马，无价值的人，畜牲
conifer |  n. 针叶树
cultivable |  adj. 能耕种的，能栽培的
depletion |  n. 消耗,罄尽,放血
dinosaur |  n. 恐龙 // n.(俚)过时、落伍的人或事物
doomed |  adj. 命中注定的 // 动词doom的过去式和过去分词
endemic |  adj. 风土的, 地方的 // n. 地方病, 风土病
exploiter |  n. 开拓者；剥削者
falcon |  n. 猎鹰
functional |  adj. 功能的,有功能的,实用的
grower |  n. 栽培者, 生长物
increment |  n. 增加(增加物, 增量, 余差)
industrialization |  n. 工业化
infest |  v. 骚扰,群居于,大批出没
inspection |  n. 检查,视察
institutional |  adj. 制度上的，惯例的，机构的
insufficient |  adj. 不足的
integrity |  n. 诚实, 正直, 完整, 完善
interception |  n. 截取, 拦截, 窃听
landmass |  n. 大陆
maize |  n. 玉米
measurement |  n. 测量,衡量,尺寸,大小
meltdown |  n. （核反应堆核心的）熔毁，灾难，崩溃
misconception |  n. 误解, 错误想法
modification |  n. 修正, 修饰, 修改
monoculture |  n. 单一栽培, 单作
nutritional |  adj. 营养的,滋养的
pesticide |  n. 杀虫剂
prehistoric |  adj. 史前的
pristine |  adj. 远古的, 原始状态的, 未受损的, 新鲜而纯净的
quarantine |  n. 四十天,隔离,封锁交通,检疫期间 // vt. 检疫,停止交涉 // vi. 检疫
reconciliation |  n. 调和(和解,一致,甘愿)
replenish |  vt. 补充,再装满 // vi. 补充
residue |  n. 残渣,剩余,余数
industry |  n. 工业,产业,勤勉,刻苦
slaughter |  n. 残杀, 屠杀, 大量杀戮 // v. 残杀, 屠杀
starch |  n. 淀粉 // vt. 给...上浆
storage |  n. 储存体, 储藏, 仓库, 保管费
stump |  n. 残株, 烟蒂, 讲演台 // v. 砍断, 蹒跚而走
sulfur |  n. 硫 // vt. 用硫处理液化
tract |  n. 广阔的土地,地域,器官系统,宣传小册子
transportation |  n. 运输, 运输系统, 运输工具
unbroken |  adj. 不间断的, 未破的，未驯服的，未被打扰的
unchecked |  adj. 未加抑制的，未经检验的
vestige |  n. 遗迹, 退化的器官
virgin |  n. 处女,未婚女子 // adj. 纯洁的, 原始的，未开发的 // 维尔京群岛
visibility |  n. 能见度
physical |  adj. 身体的,物理的,物质的 // n. 体检
intervene |  vi. 插入,介入,干涉,调停 // [计算机] 介入
vivid |  adj. 生动的,强烈的,鲜艳的,清晰的,逼真的
specimen |  n. 样本,标本
emission |  n. 发射, 射出, 发行
superior |  n. 上级,高手,上标 // adj. 上层的,上好的,出众的,高傲的
embark |  vt. &vi. 乘船,着手,从事
furnish |  vt. 布置,提供,装备
bold |  adj. 大胆的,粗体的,醒目的，无礼的,陡峭的
continuous |  adj. 连续的, 继续的, 连绵不断的
terminology |  n. 术语,术语学
enfranchise |  vt. 给与自治权, 给与选举权, 解放
breakdown |  n. 崩溃,故障,分类,腐烂,失败,一种街舞
deficiency |  n. 缺乏,不足,缺点
adolescent |  adj. 青春期的, 青少年的 // n. 青少年
amateur |  adj. 业余(爱好者)的 // n. 业余爱好者,外行
absurd |  adj. 荒唐的 // n. 荒唐
stress |  n. 紧张, 压力 // v. 强调, 着重 // vt. 强调 // n.负载
destiny |  n. 命运
impulse |  n. 冲动, 驱动力, 倾向, 心血来潮 // vt. 推动
supervise |  vt. 监督,管理,指导
complex |  adj. 复杂的 // n. 复合体
guarantee |  n. 保证(书), 担保(书) // n. 担保人; 抵押品 // vt. 保证, 担保
existence |  n. 存在, 生存
dominating |  adj. 主要的，专横的，独裁的 // 动词dominate的现在分词形式
alongside |  adv. 在旁边 // prep. 在...旁边
moreover |  adv.再者； 此外； 而且； 同时
perception |  n. 感知, 认识, 观念
popularity |  n. 普及,流行
detailed |  adj. 详细的
socialize |  vt. 使...社会化，使...社会主义化，使适应社会需要 // vi. 交际
acidic |  adj. 酸的,酸性的
acupuncture |  n. 针灸,针治 // v. 施以针灸
alkali |  n. 碱
alkaloid |  n. [生化]生物碱, 植物碱基
aromatherapy |  用香料按摩
asthmatic |  adj. 哮喘的 // n. 哮喘症患者
bicarbonate |  n. [化]重碳酸盐，碳酸氢盐
biochemical |  adj. 生物化学的
complementary |  adj. 补充的, 互补的
detoxification |  n. 解毒，去毒作用
detoxify |  vt. 除去 ... 的毒物，解毒
diarrhea |  n. 痢疾,腹泻
duodenal |  adj. 十二指肠的
duodenum |  n. [解剖]十二指肠
emphysema |  n. 肺气肿
formaldehyde |  n. 甲醛，福尔马林
gaseous |  adj. 气体的, 气态的
hepatitis |  n. 肝炎
herb |  n. 药草, 香草
herbal |  adj. 草药的
herbalist |  n. 草药医生
holistic |  adj. 整体的, 全盘的
homeopathy |  n. 顺势疗法
humidifier |  n. 增湿器
hygienic |  adj. 卫生学的, 卫生的
incremental |  adj. 增量的,增加的
inflammation |  n. 发炎, 红肿, 炎症
inhalation |  n. 吸入, 吸入药剂
irritant |  adj. 刺激的, 刺激性的 // n. 刺激物, 刺激剂
itchy |  adj. 痒的
kerosene |  n. 煤油
membrane |  n. 薄膜,膜皮,羊皮纸
metabolic |  adj. 新陈代谢的
microorganism |  n. 微生物
monoxide |  n. 一氧化物
nasal |  adj. 鼻的, 鼻声的, 护鼻的 // n. 鼻音, 鼻音字
nausea |  n. 反胃,晕船,极度的不快
nicotine |  n. 尼古丁
nitrogen |  n. 氮
noxious |  adj. 有害的, 有毒的
odourless |  adj. 没有气味的 // =odorless(美)
peptic |  adj. 有助消化的, 胃液素的 // n. 健胃剂, 消化器官
perceptual |  adj. 感性的, 知觉的
periodic |  adj. 周期的, 定期的，间歇的，完句的
phlegm |  n. 痰, 粘液, 粘液质
physiological |  adj. 生理的, 生理学的
psychiatric |  adj. 精神病的，治疗精神病的
psychogenic |  adj. 精神起因的
pulmonary |  adj. 肺的，肺部的，肺状的
radon |  n. 氡
respirator |  n. 呼吸器
severity |  n. 严格, 严重, 激烈
sodium |  n. 钠
susceptibility |  n. 敏感性，感受性，磁化率 // (复数）susceptibilities:感情
workplace |  n. 工作场所
minimise |  vt. 成极小(求最小值, 轻视, 信务剧减)
transcription |  n. 抄写，誊写，录音，编曲 // [生]转移
utterance |  n. 说话, 发表, 说话的方式
hurl |  n. 用力的投掷 // v. 用力投掷, 愤慨地说出, 丢下
invoke |  vt. 求助,用咒语召唤,请求,应用,引起 // [计算机] 调用
pioneer |  n. 先锋,拓荒者,先驱生物 // vt. 提倡,开辟 // vi. 做先驱
mundane |  adj. 世俗的，平凡的；世界的，宇宙的
foreseeable |  adj. 可预见到的
humanistic |  adj. 人文主义的, 人本主义的, 人道主义的
onwards |  adv. 向前，前进，在前面 // =onward
revelation |  n. 揭露,泄露,发觉
attainable |  adj. 可达到的, 可获得的
progression |  n. 前进
reputable |  adj. 受好评的, 有声望的, 规范的
qualification |  n. 资格, 条件, 限制
unparalleled |  adj. 无比的, 优良无比的, 空前的
dominate |  v. 支配, 占优势，俯视
term |  n.学期； 条款； 术语； 期限 // vt.把…称为； 把…叫做
in terms of |  adj. 按照(依据,用...词句,用...来,通过)
take the lead |  vt. 引导(带头,做榜样)
in the end |  终于, 最后
face with |  面对 ...
domination |  n. 支配, 控制, 管辖 // （复数）dominations:[宗]主天使
animate |  v. 使...有生气,赋予生命,促使 // adj. 有生命的；有活力的
together with |  同...一起, 连同
slapstick |  n. 打闹剧（演员用击板相互追打发出声响得名)，击板
avant-garde |  先锋派
overshadow |  v. 遮阴,使阴暗,使失色
adapt to |  适应
abbreviation |  n. 缩写
alphabetic |  adj. 照字母次序的, 字母的
ambient |  adj. 周围的,包围着的,(尤指音乐）产生轻松氛围的 // n. 环境
amplitude |  n. 广阔, 充足, 增幅 // n. 振幅、波幅(物理)
antenna |  n. 触角,天线,感觉,直觉
asphalt |  n. 沥青 // v. 用沥青铺路
bearing |  n. [机] 轴承；关系；方位；举止 // v. 忍受（bear的ing形式）
commendable |  adj. 值得赞美,很好的,可钦佩的
corrosion |  n. 侵蚀(腐蚀, 锈)
cumulative |  adj. 累积的，附加的
curvature |  n. 弯曲, 曲率
detriment |  n. 损伤，引起损害的物质
dielectric |  n. 电介体
discomfort |  n. 不便之处, 不适 // vt. 使不适
electromagnet |  n.电磁石,电磁体
electromagnetic |  adj. 电磁的
endurance |  n. 忍耐, 忍耐力, 耐性
fiber |  n. 纤维(物质),力量
freckle |  n. 雀斑, 斑点 // v. 长雀斑
fungal |  adj. 真菌的，由真菌引起的
gamma |  n. 伽玛(希腊字母), 微克，[化]第三位的东西
hopscotch |  n. 跳房子（一种儿童游戏） // vi. 像玩跳房子游戏那样跳
magnetism |  n. 磁性, 吸引力, 磁学
melanoma |  n. [医]（恶性）黑素瘤
occurrence |  n. 发生,事件,发现
osteoporosis |  n. 骨质疏松症
parameter |  n. 参数,参量,决定因素
practitioner |  n. 从业者
pulse |  n. 脉冲,脉波,脉搏 // vt. &vi. 跳动,脉跳
punctuation |  n. 强调,标点
radar |  n. 雷达
reflexology |  n. 反射学，反射疗法
repertoire |  n. (准备好演出的)节目, 保留剧目, (计算机的)指令表, 指令系统, &lt;美&gt;(某个人的)全部技 // 能, 清单,指令表
resolution |  n.决心； 解决； 坚决； 分辨率
skeletal |  adj. 骨骼的, 骸骨的
structure |  n. 结构,构造,建筑物 // v. 构成,建立,建造
sunburn |  n. 日灼, 晒伤 // v. 晒黑，晒伤
sunscreen |  n. (防晒油中的)遮光剂
suntan |  n. 晒黑的肤色
tanning |  n. 硝皮, 制革法, 晒成褐色 // 动词tan的现在分词
telecommunication |  n. 电传视讯, 远距离通信, 电磁通信 // （复数）telecommunications: 电信学
telegraphy | 电信技术
therapist |  n. 临床医学家
ticker |  n. 滴答作响的东西 // n. 股票行情自动收录器 // n. &lt;俚语&gt; 表 // n. &lt;俚语&gt; 心脏
transmission |  n. 传输, 播送, 变速器, 传递的信息
troop |  n. 群,组,军队,大量,童子军 // vi. 群集,结队,成群前行,陪伴
typesetter |  n. 排字工人，排字机
undersea |  adj. 海底的 // adv. 在海面下(=underseas)
vascular |  adj. 血管的, 脉管的，充满活力的
consensus |  n. 共识，一致，合意 // n. [生理]交感
premise |  vt. 引出，预先提出；作为…的前提 // n. 前提；上述各项；房屋连地基 // vi. 作出前提
respondent |  n.回答者； [法]（特指离婚诉讼的）被告； [生]反应，反射 // adj.应答的； 有反应的； [法]被告的
elitist |  adj. 杰出人物(统治论)的 // n. 杰出人物
essentially |  adv. 本质上,本来
reasonable |  adj. 合理的,有道理的,适度,通情达理的 // adv. 合理地
envelope |  n. 信封, 封皮,壳层
discern |  vt.看出； 理解，了解； 识别，辨别 // vi.辨明，分清
inclusive |  adj. 包含...在内的, 包罗广泛的, 包括端点的 // [计算机] 包括的
basically |  adv. 基本上, 主要地
blow up |  vt. 爆发(鼓起,放大)
apart from |  adj. 离开(除了...之外, 缺少, 除...以外, 且不说)
write |  v. 写
write up |  adj. 写到最近的事情(详细地写下来,赞扬)
reaction |  n. 反应,反作用力,化学反应
intrigue |  n. 阴谋,复杂的事,私通 // vt. 欺骗,激起...的兴趣 // vi. 密谋
propellant |  n. 使推进之物,发射火药,推进燃料
blow out |  vt. 吹灭(突然爆裂,吹胀,突然冒出,烧断)
attach to |  附在 ... 上，系在 ... 上
build up |  vt. 建立,逐步增长,增进，加强，积累
barrage |  n. 弹幕, 掩护炮火 // n. 拦河坝 // vt. 以密集火力进攻
prop up |  v. 支撑, 支持
inhibit |  vt. &vi. 禁止,抑制 // [计算机] 禁止
formulation |  n. 形成, 简洁陈述, 公式化
generalization |  n. 一般化, 普遍化, 概括，泛论
exploratory |  adj. 勘探的，探索的
turn out |  vt. 翻转, 生产, 关闭, 出动, 证明是
specialize in |  专攻，专门从事于(某一科目), 专门研究
burrow into |  探查
hollow out |  挖空，挖洞，开凿
deprive of |  剥夺，使失去 ... (权利）
subsidy |  n. 补助金, 津贴
natural |  adj.自然的； 物质的； 天生的； 不做作的 // n.自然的事情； （生来的）白痴； [乐]（风琴等的）白键
convert into |  把...转变成
relation |  n. 关系,家人,亲戚,叙述,陈述
altimeter |  n. 高度计
animated |  adj. 生气勃勃的,栩栩如生的，动画片的
animation |  n. 活泼,有生气,卡通制作
auteur |  n. (具有自己独特风格的)电影导演
autobiographical |  adj. 自传的,自传体的
bulk |  n. 大部分, 大多数, 大块, 大批, 容积, 体积 // vi. 变大, 增加 // vt. 膨胀, 出现 // adj. 大量的
cartography |  n. 地图制作,制图法,制图
container |  n. 容器, 集装箱
containerization |  n. 集装箱化 // =containerisation(英)
cosmology |  n. 宇宙学, 宇宙天体学
cosmos |  n. 宇宙 // (复数）cosmos或cosmoses:大波斯菊
crusade |  n. 改革运动 // Crusade // n.十字军东征 // vi. 从事改革
cylindrical |  [计算机] 圆柱的
dichotomy |  n. 两分, 分裂, 二分法
diesel |  n. 柴油机,内燃机
diorama |  n. 透视画
director |  n. 董事,经理,主管,指导者,导演
engrave |  v. 雕刻
fictional |  adj. 虚构的, 编造的, 小说式的
filmmaker |  n. 电影摄制者
freight |  n. 船货,运费,货运 // vt. 装货,运送,使充满（某种心情或口气）
genre |  n. 类型,流派
geographer |  n. 地理学者
hypothesize |  v. 假设, 假定, 猜测
illumination |  n. 照明, 阐释, 启发
intercontinental |  adj. 大陆间的,洲际的
interlude |  n. 中间, 中间时间, 介在中间的事件
itinerary |  n. 旅程, 旅行指南, 游记 // adj. 巡回的, 游历的, 旅程的
kinetoscope |  n. 活动电影放映机
legendary |  adj. 传说的, 富有传奇色彩的, 传奇的
logistics |  n. 后勤学 // Logistics department 物流部
longitude |  n. 经度
mapmaker |  n. 地图制作者, 制图师
maritime |  adj. 海的, 海上的, 海事的
marking |  n. 印记, 作记号，打分 //  动词mark的现在分词
Mecca |  n. 众人渴望去的地方 // Mecca n. 麦加(沙特阿拉伯城市)
missionary |  n. 传教士, 负有任务者, 工作人员 // adj. 传教的, 负有使命的
monopolistic |  adj. 独占性的,专卖的,独占论者
myth |  n. 神话
navigation |  n. 航行, 航海, 导航
natation |  n. 游泳，游泳技术
optic |  n. 镜片 // adj. 光的(视觉的)
paradise |  n. 天堂
pixel |  像素
propulsion |  n. 推进, 推进力
Ptolemy |  n. 托勒密(古埃及托勒密王朝之王) // n. 托勒密(公元2世纪的古希腊天文学家、地理学家、数学家，地心说的创立者)
sector |  n. 扇形,扇区,部门,区域 // vt. 分区
selective |  adj. 选择的, 选择性的
spatial |  adj. 空间的
spherical |  adj. 球的, 球面的, 球状的
supersonic |  adj. 超声波的，超音速的 // n. 超声波，超音速（飞机）
tanker |  n. 油轮，坦克中一员
theodolite |  n. 经纬仪
transoceanic |  adj.在海洋彼岸的,横越海洋的
triangulation |  n. 三角测量法, 形成或分成三角(关系)
vignette |  n. 小插图, 晕映照, 简介, 简述, 小场景 // vt. 晕映, 简洁地表述
woodcut |  n. 木刻，木刻画
look through |  v.看穿, 审核, 浏览, 温习, 从...中显露, 彻底审查
availability |  n. 有效,有用,有益；可得到的人(或物)
payable |  adj. 可付的, 应付的, 有利益的
departure |  n. 离开,出发,分歧
on receipt of |  在收到 ... 后
solicitor |  n. 律师
range from |  vt. 从 ... 到 ... 变动(从 ... 到 ... 范围，延伸，绵亘)
associated |  adj. 联合的,相关的
keep a record of |  为 ... 作记录
receipt |  n. 收据
encode |  vt. 编码, 译码
in search of |  寻找, 寻求
a troop of |  adj. 一群
entrance |  n. 入口 // v. 使出神,使入迷 // vt. 使出神
revolutionize |  vt. 使革命化，使彻底变革  // vi. 变革 // =revolutionise（英）
obviously |  adv. 显然地
on display |  adj. 公开展出
otherwise |  adv. 否则,不同地,在不同方面 // pron. 其他 // adj. 不同的
dietician |  n. 营养学家
acuity |  n. 尖锐, 敏锐, 激烈
aerial |  adj.空气的； 航空的，空中的； 空想的 // n.[电讯] 天线
aerobic |  adj. 需氧的, 有氧的, 增氧健身法的
algorithm |  n. 算法
anaerobic |  adj. 厌氧的
aniline |  n. 苯胺 // adj. 苯胺的
anionic |  adj. 阴离子的
aquifer |  n. 含水土层(含水量足以成为井水或泉水)
archaeologist |  n. 考古学家
astronomer |  n. 天文学家
atlas |  n. 地图集 // Atlas: 擎天神，背负重物的人
baseline |  n. 基线，底线
basin |  n. 脸盆, 盆地, 流域, 水池
carbon |  n. 碳,灯芯,复写纸
cardinal |  n.红衣主教，鲜红色，基数，北美红雀 // adj. 主要的，深红色的
cartographer |  n. 地图制作者, 制图师
cellulosic |  adj. 纤维素的
chromic |  adj. 铬的, 含三价的铬的
circumference |  n. 圆周, 周围, 胸围
cochineal |  n. 虫红, 胭红, 燕脂虫
colonial |  adj. 殖民地的 // n. 殖民地居民
continental |  adj. 大陆的
copperplate |  n. 铜板, 铜版, 铜板印刷
correlation |  n. 相互关系,相关,关连
cubic |  adj. 立方体的
dam |  n. 水坝 // vt. 筑坝,抑制(情感）等
disperse |  vt. 分散,传播,散开 // vi. 分散
equatorial |  adj. 近赤道的, 赤道的
fastness |  n. 要塞, 城堡, 坚固，快速，偏远的地方
flax |  n. 亚麻, 麻布, 亚麻织品
geyser |  n. 天然热喷泉，间歇泉 // n. 热水器
habitable |  adj. 可居住的，适于居住的
henna |  n. 指甲花, 指甲花染料, 红褐色 // vt. 用指甲花染料染
hydrogen |  n. 氢
hydrothermal |  adj. 水热作用的, 热液的
incubation |  n. 孵化；[病毒][医] 潜伏；抱蛋
indigo |  n. 靛青, 紫蓝色 // adj. 紫蓝色的
inorganic |  adj. 无机的, 无生物的，非自然生长的
insoluble |  adj. [化]不能溶解的, 不能解决的
jute |  n. [植]黄麻纤维 // Jute: 朱特人
lander |  n. 出铁槽(斜槽, 着陆器)
leakage |  n. 泄漏
Martian |  n. 火星人 // adj. 火星的
mauve |  n. 淡紫色 // adj. 淡紫色的
meteorite |  n. 陨石, 陨星
microbe |  n. 微生物
mineral |  adj. 矿物的 // n. 矿物, 矿石
molecular |  adj. 分子的
mordant |  adj. 尖酸的, 辛辣的, 有腐蚀性的 // n. 金属腐蚀剂, 金箔粘著剂 // vt. 用媒染剂处理
orbiter |  n. 盘旋物, 人造卫星
organic |  adj. 器官的,有机的,根本的,接近自然的 // n. 有机物质
oxidation |  n. 氧化（反应）
oxidizer |  n. 氧化剂
peroxide |  n. 过氧化物
photochemical |  adj. 光化作用的, 光化学的
pigment |  n. 色素, 颜料 // v. 把...加颜色, 变色
planetary |  adj. 行星的，有轨道的
portability |  n. 可移植性, 可携带, 轻便
predetermine |  vt. 预先决定
propagation |  n. 增殖, 繁殖, 广传
radiography |  n. X光线照相术, 放射线照相术
reactant |  n. [化]反应物
reactive |  adj. 反动的, 反应性的, 反冲的
redundancy |  n. 冗余,备份,多余信息
respiration |  n. 呼吸；呼吸作用
seepage |  n. 泄漏，渗出的量
spectral |  adj. 波谱的
sulfur dye |  硫化染料
sulphur |  n. 硫
superoxide |  n. 超氧化物
synthetic |  adj. 综合的,合成的,人造的 // n. 人工制品
tannin |  n. 单宁酸
telemeter |  遥测计
theological |  adj. 神学的 // =theologic
transducer |  n. 转换器, 传感器
ultrasonic |  adj. 超声波的
versatile |  adj. 多才多艺的,多方面的，通用的，
later on |  后来，过些时候
heighten |  v. 增高,提高,加强
concerned |  adj. 担忧的,关心的
in collaboration with |  与 ... 合作，与 ... 勾结
necessity |  n. 需要, 必需品, 必然
a series of |  一系列, 一连串
assimilation |  n. 同化, 同化作用, 消化
ingenuity |  n. 智巧, 创造力, 精巧的设计
anthropology |  n. 人类学
peak |  n. 山顶,顶点,帽舌 // vi. 到达高点,消瘦 // vt. 使到达顶峰,竖起 // adj. 处于顶峰状态的
seasonal |  adj. 季节的, 依照季节的, 周期性的
irritable |  adj. 易怒的,急躁的 // adj. 【医】过敏的，易感受刺激的,
legislation |  n. 立法, 法律
in proportion |  按比例，相应地
reverse |  n. 相反; 背面; 失败, 挫折 // adj. 反面的, 相反的, 颠倒的 // v. 颠倒, 逆转, 倒退
populace |  n. 平民, 大众
comparable |  adj. 可比较的, 比得上的
prosperous |  adj. 繁荣的, 兴旺的
rational |  adj. 合理的,理性的,能推理的 // n. 有理数
ruthless |  adj. 残忍的, 无情的
sedentary |  adj. 久坐的, 固定不动的
susceptible |  n. 易受影响者,易受感染者 // adj. 易受影响的,易感动的,容许
troublesome |  adj. 令人烦恼的, 讨厌的，困难的，棘手的
universal |  adj. 普遍的,通用的,宇宙的 // n. 通用
vain |  adj. 徒然的, 虚荣的, 空虚的
virtual |  adj. 虚拟的；有效的；实质上的，事实上的
ambiguity |  n. 不明确,含糊,暧昧,模棱两可
digital |  adj. 手指的,数字的,数码的,电子的
appliance |  n. 器具,器械,装置,应用
household appliance |  n. 家用电器
atomic |  adj. 原子的, 原子能的
attachment |  n. 附件, 附著, 附属物, 依恋, 忠诚，依赖 // [法律]扣押令
automata |  n. 自动机器，自动装置，机械地动作的人 // 名词automaton的复数形式
automation |  n. 自动化
banking |  n. 银行业
barrel |  n. 桶, 一桶的量, 大量, 枪管, 炮管, 笔管, 汽油桶 // vi. 快速移动 // vt. 把...装桶
barter |  n. 物物交换, 实物交易 // v. 物物交换, 交换
bezant |  各种金 // 银币饰
bimetallic |  adj. 二金属的, 复本位制的
bond |  n. 债券；结合；约定；粘合剂 // vi. 结合，团结在一起 // vt. 使结合；以…作保
bullion |  n. 金银, 金银块, 金银丝花边
calibration |  n. 刻度,校准，
carat |  n. 克拉, 开(以纯金为24开表示金含量的单位) // =karat
cheque |  n. 支票
chronograph |  n. 计时器
chronometer |  n. 天文,航海用的精密时计,精密的时钟
coinage |  n. 造币，货币制度，硬币 // n. 创造新词
Constantinople |  n. 君士坦丁堡（土耳其城市）
copper |  adj. (紫)铜色的,铜(制)的 // n. 铜,铜币,铜制品
counterfeiter |  n. 伪造者
cumbersome |  adj. 笨重的
debit |  n. 借方, 借, 借项, 缺点 // vt. 记入借方
deferred |  adj. 延期的, 缓召的
demonetize |  v. 使通货废止通用
dial |  n. 刻度盘,针面,转盘 // vt. 用仪表测量，操作仪表 // vi. 拨号，用仪表测量 // [计算机] 拨号
drachma |  n. 德拉克马(古希腊的银币名，现代重量单位)
drip |  n. 滴, 点滴, 乏味的人, 水滴 // v. 滴下, 漏水
escapement |  n. 擒纵机，逃脱
fountain |  n. 喷泉,源泉,储水容器,泉水 // vt.& vi. 使像喷泉一样流
fuse |  n. 保险丝,引线,导火线 // vt. 熔化,融合,装导线,装引信于 // vi. 熔化,融合
granary |  n. 谷仓, 谷物仓, 谷产丰富的地区
hinged |  adj. 用(有)铰链的 // 动词hinge的过去式和过去分词形式
hoard |  v.&amp;n. 贮藏,秘藏 // vt. 贮藏
hoe |  n. 锄头 // v. 锄地，铲除
horology |  n. 测时法, 钟表制造术
hourglass |  n. 时漏, 砂漏, 水漏 // adj. 沙漏状的
hyperinflation |  n. 恶性通货膨胀
intangible |  adj. 难以明了的,无形的 // n. 无形的东西
interchangeable |  adj. 可互换的
lambskin |  n. 羔羊皮, 羊皮纸
liquid |  adj. 液体的, 液态的 // n. 液体
mainspring |  n. 主要动力；（钟表）主发条；主要原因；主要动机
measure |  n. 措施, 办法, 量度, 尺寸 // v. 测量, 量
metallic |  adj. 金属的
mint |  n. 薄荷,造币厂,巨额 // vt. 铸造,铸币,伪造 // adj.薄荷的,造币厂的,无损坏的
metallurgy |  n. 冶金学，冶金术
monetary |  adj. 货币的,金融的
nominal |  adj. 名义上的,有名无实的,名词性的 // n. 名词词组
obelisk |  n. 方尖石塔,短剑号,疑问记号
pendant |  n. 垂饰
pendulum |  n. 摆, 钟摆，摇摆不定的事态（或局面）
quart |  n. 夸脱（容量单位）
ratchet |  n. 棘轮，棘齿 // v. （使）渐进 // =rachet
shockproof |  adj. 耐震的(防震的, 抗震的, 耐电击的)
sundial |  n. 日规,日晷仪
synchronize |  v. 使同时, 同时发生
timekeeping |  n. 计时, 测时, 准时
transaction |  n. 交易,处理,办理
uniformity |  n. 同样,一致(性)
winder |  n. 缠绕者，卷扬机，楼梯的斜踏步，上发条的钥匙
wristwatch |  n. 手表
prolong |  vt. 延长,拖延
scientific |  adj. 科学的
transplant |  vt. 移居, 移栽(植物), 移植(器官) // vi. 能经得住移植 // n. 移植, 被移植的事物
antique |  adj. 古代的 // n. 古物, 古董
embody |  vt. 代表, 使具体化, 包含,使(精神)肉体化
popularize |  v. 普及, 使流行，使通俗化
prestige |  n. 威望,声望
prevalence |  n. 传播, 流行, 普及
revive |  vt. 使重生,恢复精神,重新记起,唤醒 // vi. 复生
compassionate |  adj. 有同情心的 // vt. 同情
gossip |  n.  闲聊,随笔 // vi. 散播流言蜚语
sexual |  adj. 性的，性欲的，有性的
assault |  n. 攻击, 突袭 // vt. 袭击, 突袭
compassion |  n. 同情,怜悯
competence |  n. 能力,管辖权,技能
enlightenment |  n. 启蒙 // n.【佛教】 开悟
esteem |  n. 尊敬 // vt. 认为,尊敬
instill |  v. 滴注,逐渐灌输(尤指思想或情感)
perplex |  v. 使...困惑, 使...更复杂, 使...为难
rebel |  n. 叛徒,起义者 // vi. 造反,反抗,反感 // adj. 造反的,反抗的,反叛者的
tease |  vt.取笑，戏弄； 挑逗； 强要 // vi.梳理（羊毛等）； 起绒 // n.爱嘲弄他人的人； 取笑卖弄风骚的人
slaughter |  n. 残杀, 屠杀, 大量杀戮 // v. 残杀, 屠杀
legitimize |  vt. 使合法, 使可接受
prosperity |  n. 繁荣,兴旺
righteous |  adj. 公正的, 公义的, 当然的
estrange |  vt. 使疏远
strive |  v. 努力,奋斗,力争
avenge |  vt. 为...报复, 报仇
innocence |  n. 无罪, 无知, 天真无邪
pervert |  vt. 误用(歪曲, 曲解, 败坏, 使...反常) // n. 变态, 色狼
circuit |  n. 电路,一圈,巡回 // vt. &vi. 巡回
navigate |  vi. 航行,驾驶,操纵 // vt. 航行,驾驶
nervous |  adj. 紧张的,焦虑的,神经质的
nervous system |  神经系统
roost |  n. 栖木, 鸟窝, 休息所 // v. 栖息, 安歇
abacus |  n. 算盘,圆柱顶板
accounting |  n. 会计
auxiliary |  n. 帮助者, 辅助物, 助动词 // adj. 附加的, 辅助的
bilingualism |  n. 熟谙两种语言(的能力)
bronco |  n. 北美洲野马 // =broncho, bronc
Canberra |  n. 堪培拉（澳大利亚首都）
cellular |  adj. 细胞的,松织的 // n. 手机
computational |  adj. 计算的，电脑的
counting |  n. 计算
cuneiform |  adj. 楔形的, 楔形文字的 // n. 楔形文字，楔形骨
Czechoslovakia |  n. 捷克斯洛伐克（欧洲国家名）
decode |  v. 解码, 译解 // [计算机] 译码
deflect |  vt. 使转向；使偏斜；使弯曲 // vi. 转向；偏斜
digger |  n. 挖掘者，采掘机 // Digger // n. 澳大利亚士兵，新西兰士兵
dot |  n. 小圆点,少量,小东西 // vt. 作小点记号,点缀 // vi. 作小点记号 // [计算机] 点
facsimile |  n. 摹本，传真 // v. 复制,摹写，传真
fortune |  n. 财产,命运,运气
gravel |  n. 碎石 // v. 铺碎石, 使困惑
kiln |  n. 窑,炉,干燥炉 // v. 烧窑,在干燥炉干燥
knot |  n. 结,难题,一小群 // vi. 打结 // vt. 把...打成结,系牢,捆扎
linguistics |  n. 语言学
lynch |  vt. 处以私刑, 加私刑 // n. 私刑, 私罚
mark |  n. 污迹, 标记, 分数, 烙印, 纪录 // vt. 做标记于, 留意, 打分数, 留下污痕, 使...明显 // vi. 做标志, 记分, 留下印记
Melbourne |  n. 墨尔本（澳大利亚城市）
multilingual |  adj. 使用多种语言的
multimedia |  adj. 多媒体的 // n. 多媒体
multiplex |  adj. 多样的, 复合匙, 多重发讯的, 多元的 // v. 多重发讯
multiplication |  n. 乘法,增加,乘法表 // [计算机] 乘法
nugget |  n. 金属块，珍品，珍闻，（鸡）块
operator |  n. 操作员,管理者,技工,报务员
opportunist |  n. 机会主义者, 投机者 // adj. 机会主义者的
ornamental |  adj. 装饰的 // n. 装饰品
parliamentary |  adj. 国会的, 议会的, 议会制度的
pawn |  n. 典当, 抵押物, 人质, (国际象棋中)卒 // vt. 典当, 以…为担保
penny |  n. 便士,小钱,少量
pictograph |  n. 象形文字，统计图表
pledge |  n. 保证,誓言,抵押,抵押品 // vt. 保证,誓言,举杯祝...健康
positional |  adj. 位置的, 地位的, 阵地的
pottery |  n. 陶器
purity |  n. 纯净, 纯正, 纯粹
ravage |  n. 破坏, 蹂躏 // v. 毁坏, 破坏, 掠夺
reed |  n. 芦苇, 芦笛,簧片 // Reed：里德（姓氏）
reimburse |  vt. 偿还,报销
safekeeping |  n. 妥善保管
schist |  n. 片岩
seigniorage |  n. 硬币铸造利差, 君主的特权, 货币铸造税, 特许捐 // =seignorage
settler |  n. 移居者；殖民者
steppe |  n. (特指西伯利亚一带没有树木的)大草原
sterling |  adj. 英币的(纯粹的, 货真价实的) // n. 英国货币(英镑)
subtraction |  n. 减法, 减去
suppression |  n.  镇压, 抑制
tally |  n. 计数器,记分,一致, 测量 // vt. 计算,记录,使一致 // vi. 计算,记分,一致
tangible |  adj. 有形的, 可触摸的, 确凿的, 实际的
territory |  n. 领土, 版图, 领域, 范围
token |  n. 表征, 记号, 特点, 纪念品, 代币, 代表人群 // adj. 象征性的, 敷衍的
touchstone |  n. 试金石，检验标准
transcontinental |  adj. 横贯大陆的,大陆那边的
tributary |  adj. 纳贡的, 从属的, 补助的 // n. 纳贡者, 属国, 支流
tribute |  n. 贡品,颂词,称赞,(表示敬意的)礼物
burrow |  n. (兔子等)所掘的地洞 // v. 挖洞 // vi. 翻寻,挖洞 // vt. 挖掘(洞穴),钻进
photocopy |  n. 影印本 // v. 影印
swap |  n. 交换 // vt. &vi. 交换,用...作交易
discard |  n. 丢牌,废牌 // vt. 丢弃,抛弃 // vi. 丢牌
ridiculous |  adj. 可笑的；荒谬的
mechanical |  adj. 机械的,力学的,呆板的    // n.(供制版用的)样书, 版面设计
intelligence |  n. 理解力, 智力, 情报, 情报工作, 情报机关
clot |  n. 凝块，血块，一推，一群 // n. 笨蛋，傻瓜 // v. 凝结, 使...凝结，阻塞
captive |  n. 俘虏, 迷恋者 // adj. 被俘的, 被迷住的
acquisition |  n.获得； 购置物； 获得物； 收购
facility |  n.设备； 容易； 能力； 灵巧
campaign |  n. 战役; 运动, 活动 // vt. 参加竞赛 // vi. (从事, 组织)活动
discriminate |  vt. 区分，区别对待 // vi. 辨别，差别对待
rigid |  adj. 僵硬的,刻板的,严格的
compensation |  n. 补偿, 赔偿; 赔偿金, 物
contribute |  vt. 捐助,投稿 // vi. 投稿,贡献,是原因之一
string |  n. 线,一串,字串 // vt. 串起,成串,收紧, 悬挂；系；扎 // vi. 给…装弦 // adj. 线的
destruction |  n. 破坏,毁灭,破坏者
arrange |  vt. 安排,整理,计划,改编(乐曲) // vi. 协商,计划
demographic |  人口统计学的 // adj. 人口的,人口统计的
extract |  n. 榨出物,精华,摘录 // vt. 拔出,榨出,摘录,提取,选取 // [计算机] 提取
conflict |  n.冲突； 战斗； 相互干扰； 矛盾 // vi.抵触； 争斗； 战斗； 冲突
slight |  n. 轻蔑 // adj. 轻微的,纤细的,脆弱的 // vt. 轻视,忽略
genetic |  adj. 基因的, 遗传的, 起源的
removal |  n. 移动, 移居, 除去
facilitate |  vt. 帮助, 使...容易, 促进
lower |  adj. 低的, 下级的, 下层的 // vt. 降低, 跌落, 减弱, 贬低 // vi. 皱眉, 降低, 阴沉, 变少 // n. 皱眉, 下级, 阴沉的样子, 前兆
nickel |  n. 镍, 镍币, 五分镍币 // vt. 镀镍于
mainstream |  n. 主流
stockpile |  n. 囤储物资 // vt. 储备, 储存
surgery |  n. 外科,外科手术, 诊所
soluble |  adj. 可溶解的，可解决的
procedure |  n. 程序, 手续, 步骤; 常规的做法
criticize |  vt. 批评, 吹毛求疵, 非难 // vi. 批评
confirm |  v. 确定, 批准, 证实
jealous |  adj. 妒忌的,戒备的
curiosity |  n. 好奇, 好奇心
behave |  vt. &vi. 举止,行为,举止端正
abstract |  n. 摘要,抽象的东西 // adj. 抽象的,理论的 // vt. 移除,摘要,偷 // vi. 做摘要
acknowledgment |  n. 承认, 承认书, 感谢 // =acknowledgement
aspect |  n. 方面, 外貌, 外观; 方位, 方向
battered |  adj. 撞坏的, 打垮的, 磨损的, 憔悴的 // 动词batter的过去式和过去分词
burnout |  n. 燃料烧尽, 精疲力尽
bystander |  n. 旁观者
condemned |  adj. 被责难的, 被宣告有罪的 // 动词condemn的过去式和过去分词
conflation |  n. 混合，熔合
conglomerate |  adj. 密集而固结的, 成簇的 // n. 联合企业, 密集体, 城郊混合区 // vt. 凝聚成一团,使结成,结合
consistency |  n. 坚持, 一致性, 强度, 硬度, 浓稠度
corporation |  n. 公司, 法人, 集团
counselor |  n. 顾问, 参事, 法律顾问
cursive |  adj. 草书的, 草书体的 // n. 草书, 草书原稿
dependency |  n. 依赖，属国, 保护地，从属物
despicable |  adj. 可鄙的, 卑劣的
distressing |  adj. 使人痛苦的, 令人烦恼的 // 动词词distress的现在分词形式
enumerate |  v. 列举,计算,枚举 // [计算机] 枚举
exploration |  n. 探险,踏勘,探测
fiscal |  adj. 财政的,国库的
fixate |  v. 早期停止性的成熟, 视线移向, 注视
flexitime |  n. 弹性上班制 // =flextime
fluent |  adj. 流利的, 流畅的
footnote |  n. 脚注, 补充说明 // vt. 给...作脚注
frantic |  adj. 疯狂的, 狂乱的
fuzzy |  [计算机] 模糊的 // adj. 毛茸茸的，模糊的，含糊不清的（感情）
gentle |  adj.温和的； 文雅的； 高尚的 // vt.使温和； 使驯服 // n.蛆； 饵
gift |  n. 礼物,天赋,赋予 // vt. 赠送,赋予
gist |  n. 要点, 要旨
harass |  v. 使...困扰,使...烦恼,反复袭击
hectic |  adj. 兴奋的,持续发热的,发红的
horseplay |  n. 喧闹的嬉戏
immersion |  n. 浸入(专心)
inexcusable |  adj. 不可宽恕的, 不可原谅的
injury |  n. 受伤处,损害,伤害
innovator |  n. 改革者, 刷新者
institution |  n. 机构,惯例,创立
interactive |  adj. 相互作用的 // [计算机] 交互的
interpreter |  n. 译员,口译者，解释程序
manuscript |  adj. 手抄的 // n. 手稿, 原稿
marital |  adj. 婚姻的
meditation |  n. 沉思,冥想
monolingual |  adj. 仅用一种语言的, 仅懂一种语言的
nanny |  n. 保姆，&lt;非正式&gt;祖母，外祖母（英）
originality |  n. 独创性，创造力，新颖
overworked |  adj. 工作过度的, 过分劳累的 // 动词overwork的过去式和过去分词形式
paperback |  n. 纸封面本, 普及本, 平装书
paraphrase |  n. 释义, 解述, 改写 // v. 改写, 解述
passion |  n. 激情,热情
precondition |  n. 先决条件，前提 // vt. 预先准备
proficiency |  n. 熟练,精通
publication |  n. 出版, 发行, 出版物, 公布, 发表
regression |  n. 复原,逆行,退步
reprisal |  n. 报复, 报仇, 报复性劫掠
restatement |  n. 再声明, 重述
retaliation |  n. 报复, 反击
ringleader |  n. 魁首，头目
setting |  n.镶嵌； 环境； 装置； （某事、戏剧、小说等的）背景 // v.放( set的现在分词)； 安插； 树立； 安排
sibling |  n. 兄弟姐妹
stand up |  v. 起立，（论点、论据等）站得住脚的，经久耐用
subheading |  n. 副标题
taunt |  n. 辱骂, 嘲弄 // v. 嘲弄
teleconferencing |  远程会议, 电信会议
unambiguous |  adj. 不含糊的, 清楚的
unoriginal |  adj. 非原先的(无独创精神的, 模仿的, 抄袭的)
verbally |  adv. 口头地，词句地, 逐字地
vocalization |  n. 发声的样子, 发声法, 发声
vocalize |  v. 发声
vocational |  adj. 职业的
workload |  n. 工作量
constitute |  vt. 构成,建立,任命
corporate |  adj.社团的, 法人的, 共同的, 全体的
prevalent |  adj. 流行的, 普遍的
administration |  n. 行政,管理,中央政府
consist |  n. 组成 // vi. 组成,存在,一致
medieval |  adj. 中世纪的
magnitude |  n.巨大，广大； 重大，重要； 量级； （地震）级数
mould |  n. 模子(样板,形状,霉菌,土,类型) // vt. 模压(铸造,发霉,形成,轮廓相符合) // vi. 发霉
virtually |  adv. 几乎,实际上
cookery |  n. 烹调法, 烹调术
deceive |  vt. 欺骗 // vi. 行骗
acquire |  vt. 占有,获得,取得,学到
arthritis |  n. 关节炎
current |  n. (水、气、电)流, 趋势 // adj. 流通的, 现在的, 最近的
literature |  n. 文学, 文献
harsh |  adj. 粗糙的, 使人不舒服的，刺耳的, 严厉的，大约的
venomous |  adj. 恶意的, 有毒的
hybrid |  n. 混血儿,杂种,混合物 // adj. 混合的,杂种的,混合语的
conservative |  adj. 保守的,守旧的 // n. 保守派(党),保守的人
obtain |  vt. 获得, 得到 // vi. 通用, 流行, 存在
weakness |  n. 软弱
astound |  v. 使惊骇, 使大吃一惊 // adj. <古>震惊的
compare |  vt.&vi. 比较,比喻,对照 // n. 比较，对照
strip |  vi.剥光； 表演脱衣舞； 剥除 // vt.除去，剥去； 剥夺； 删除； 清除，拆除 // n.长条，条板； 带状地带（或森林、湖面等）； （足球队员的）运动服
preparation |  n. 准备
neglect |  n. 疏忽,忽略,怠慢 // vt. 疏忽,忽视,不顾
attain |  vt. &vi. 达到,获得
specification |  n. 规格,详述,详细说明书
visible |  adj. 可见的, 看得见的
evaporate |  v. 蒸发, 失去水分, 消失
erosion |  n. 腐蚀,侵蚀
module |  [计算机] 模块 // n. 组件
decline |  n. 衰微, 跌落; 晚年 // v. 降低, 婉谢
acidity |  n. 酸性, 酸度
adenosine |  n. [生化]腺苷, 腺嘌呤核苷
allowance |  n. 限额，定量 // n. 津贴,零用钱
altruistic |  adj. 利他主义的, 无私的
ancestral |  adj. 祖先的, 祖传的
approved |  adj. 经核准的,被认可的
arena |  n. 竞技场
carbo |  n. &lt;口&gt;碳水化合物食品，含糖食品 // n. &lt;俚&gt;汽化器 // pref. 表示“碳，碳水化合物” // =carb
carbohydrate |  n. 碳水化合物, 糖
chief |  adj. 主要的, 首席的 // n. 首领
collude |  v. 串通, 共谋
comparison |  n. 比较
competitiveness |  n. 竞争能力
complexity |  n. 复杂，复杂性, 复杂的事物
conflicting |  adj. 相冲突的 // 动词conflict的现在分词形式
contraction |  n. 收缩, 缩写式, 痉挛
contribution |  n. 贡献,捐款(赠)
creatine |  n. [生化]肌氨酸，肌肉素
dedicated |  adj. 专注的,献身的 // adj. 专用的
discouraging |  adj. 令人气馁的 // vbl. 使...气馁
doctoral |  adj. 博士的
endorsement |  n. 支持,认可,背书
formulary |  n. 公式集, 处方一览表, 定式 // adj. 规定的, 公式的, 药方的
geographical |  adj. 地理的,地理学的 // =geographic
handbook |  n. 手册, 指南
idiosyncratic |  adj. 特质的, 异质的, 特殊的
indulgence |  n. 沉溺,放纵,嗜好 // n. 【宗】(天主教)特赦;豁免
ingest |  v. 摄取，咽下
insurer |  n. 保险公司, 承保方
jerk |  n. (口语)笨蛋,性情古怪的人,急拉,肌肉抽搐 // vt. &vi. 痉挛,急拉,急推,急动
knowledgeable |  adj. 聪明的,有知识的
marathon |  n. 马拉松, 耐力的考验
metaphorical |  adj. 隐喻性的, 比喻性的
multifaceted |  adj. 多层面的
paramedic |  n. 护理人员
perfectionist |  n. 十全十美主义者, [哲]至善论者
perimeter |  n. 周长, 周界, 边缘
persuasive |  adj. 有说服力的 // n. 动机(诱因)
pharmaceutical |  adj. 药物的(医药的) // n. 药品(成药)
pharmacist |  n. 药剂师，药商
pharmacy |  n. 药房,配药学
phosphocreatine |  n. [生化]磷酸肌酸
placebo |  n. 安慰剂，安慰话
portfolio |  n. 文件夹，作品集，证券投资组合
predominate |  v. 掌握,控制,成为主流
pretax |  adj. 扣除税捐前的
promotional |  adj. 推销的, 增进的, 晋升的
reappraise |  vt. 重新评估, 重新评价
rekindle |  v. 重新点燃
relentless |  adj.不懈的； 坚韧的，不屈不挠的； 不间断的； 未减轻的
rendition |  n. 演奏, 解释，翻译 // n.投降
resilience |  n. 跳回(回弹,弹力,弹性变形,冲击值)
retail |  n. 零售 // vt. 零售 // adj. 零售的 // adv. 以零售形式
robust |  adj. 强壮的,强健的,粗野的,需要体力的,浓的
rudimentary |  adj. 基本的(初步的, 起码的, 根本的)
saturation |  n. 饱和(浸透, 磁性饱和, 色度学章度)
shallow |  adj. 浅的, 肤浅的, 浅显易懂的 // n. (pl.)浅滩, 浅处 // v. 变浅
skiing |  n. 滑雪, 滑雪术
speculation |  n. 沉思, 推测, 投机
spinning |  adj. 纺织品的 // n. 纺织
spouse |  n. 配偶 // vt. 和...结婚
stereoscopic |  adj. 实体镜的
strategic |  adj. 战略的,重要的,基本的
symbolism |  n. 象征主义, 象征, 符号化
tenure |  n.占有（职位，不动产等）； 占有期； 终身职位
toothed |  adj. 有齿的，锯齿的，锯齿状的
turbid |  adj. 混浊的, 泥水的, 浓密的
wavy |  adj. 波浪形的, 起伏的
subject |  n. 科目, 主题; 缘由 // n. (君主国)国民; 实验对象 // adj. 服从的, 易患的 // vt. 使隶属, 使服从; 使遭遇
rumor |  n. 谣言,传闻 // vt. 谣传
absenteeism |  n. 旷课, 旷工
output |  n. 产量,输出,输出功率,输出端 // vt. 输出(信息等)
vigorous |  adj. 精力充沛的,元气旺盛的,有力的
compress |  vt. 压缩, 压榨 // n. [医]敷布
manipulate |  v. 操纵,利用,假造 // [计算机] 操作
indulge |  vt. 纵情于,放任,迁就 // vi. 放纵自己于...
proceed |  vi. 继续进行; 开始, 着手
spiritual |  adj. 精神的, 心灵的 // n. (尤指美国南部黑人的)圣歌
negative |  adj. 否定的,负的,消极的 // n. 底片，负数，否定 // vt. 否定
statue |  n. 塑像,雕像
penalty |  n. 处罚,惩罚
vision |  n. 视觉,先见之明,光景,视力,眼力,幻想，影像 // vt. 幻想
probe |  n. 探针,调查,探测器 // vt. 用探针测,详细调查 // vi. 详细调查
convey |  vt. 传达,运输,转移 // [计算机] 输送
fatigue |  n.   疲乏,疲劳,累活 // adj. 疲劳的 // vt.  使...疲劳,使...心智衰弱 // vi.  疲劳
demolish |  v. 毁, 破坏, 粉碎
survey |  n. 调查; 纵览, 视察, 测量 // vt. 审视, 视察, 通盘考虑, 调查; 勘测 // vi. 测量, 勘测
cultivate |  vt. 培养,耕作,栽培,结交(朋友), 促进增长, 教养
certificate |  n. 证(明)书,执照 // vt. 批准，认可，发证书给...
evolve |  vt. &vi. 进展,进化,展开
dividend |  n. 红利,股息,意外之财, 彩金, 被除数
chronic |  adj. 长期的,慢性的,惯常的
submarine |  n. 潜水艇 // adj. 水底的, 海底的 // vt. 用潜艇袭击 // vi. 滑入...底下
sore |  adj. 疼痛的,痛心的 // n. 痛处,疮口
impede |  v. 妨碍,阻碍,阻止
legal |  adj. 法律的,合法的,法定的
alternative |  adj. 两者择一的; 供选择的; 非主流的 // n. 替换物, 取舍
stimulate |  vt. 刺激,激励,鼓舞 // vi. 起刺激作用
academic |  n. 教学人员,学术人员 // adj. 学院的,理论的,学术性的
asset |  n. 资产,有用的东西,优点,长处
accountancy |  n. 会计工作，会计学
acupuncturist |  n. 针灸医生, 针疗医生
adjunct |  n. 附属物, 附件, 修饰语
ammonia |  n. 氨水,阿摩尼亚
archipelago |  n. 群岛, 多岛海
artifact |  n. 人工制品(制造物,石器)
at fault |  出毛病，有责任，失去嗅迹而不能继续追踪
awareness |  n. 认识(了解,知道)
basalt |  n. 玄武岩
brittle |  adj. 易碎的
cavort |  vi. 腾跃, 嬉闹
chiropractor |  n. 脊椎指压治疗者, (脊柱)按摩疗法医生, 按摩师
clientele |  n. 诉讼委托人, （总称）客户
come along |  vt. 一道走
concur |  v. 意见相同, 一致, 互助
context |  n. 上下文, 环境,背景
contradiction |  n. 反驳,矛盾,不一致,否认
convection |  n. 传达, 传导, 对流
coyote |  n. [动]小狼, 丛林狼
dearth |  n. 缺乏, 粮食不足, 饥谨
disenchantment |  n. 失望，不抱幻想
disillusion |  n. 觉醒，幻灭 // vt. 醒悟，使幻想破灭
doomsday |  n. 世界末日，末日审判
dub |  vt. 配音；轻点；打击；授予称号 // n. 笨蛋；鼓声
duplicate |  n. 副本,复制品 // adj. 复制的,二重的 // vt. 复制,重复 // vi. 重复 // [计算机] 复制
emeritus |  adj. 名誉退休的 // n. 名誉退休者
engrossed |  adj. 全神贯注的 // 动词engross的过去式和过去分词形式
entrepreneurial |  adj. 企业家的, 企业性质的
entrepreneurship |  企业家[主办人等]的身分[地位、职权、能力], 创业者, 创业学, 创业精神
exodus |  n. 大批的离去 // Exodus：（《圣经·旧约》中的）出埃及记
exploitative |  adj. 开发的，利用的，剥削的
extrusion |  n. 挤出, 推出, 逐出, 压成品
exuberant |  adj. 繁茂的, 丰富的，充满活力的
finitude |  n. 有限，限定
fluency |  n. 流利，流畅
generative |  adj. 生殖的, 生产的, 有生殖力的
grinding |  adj. 磨的, 碾的, 磨擦的 // 动词grind的现在分词形式
herbalism |  n. 草药医术学
hiccup |  n.嗝； 连续地打嗝； 暂时性的小问题； 短暂的停顿 // vi.打嗝
in this respect |  在这方面
informant |  n. 通知者, 密告者 // n. 为语言研究提供资料的人
international |  adj. 国际的 // n. 国际组织
introspection |  n. 内省, 反省, 自省
kaleidoscope |  n. 万花筒，千变万化
kitten |  n. 小猫 // vi. 生育小猫
length |  n. 长度,篇幅
macadamia |  n. 澳洲坚果树，马卡达姆坚果
methodology |  n. 一套方法,方法学
naturalistic |  adj. 自然的,自然主义的,博物学的
naturopath |  n. 自然疗者, 理疗家
officiate |  v. 执行职务, 主持（仪式等）
optimum |  n. 最适宜 // adj. 最适宜的
opulence |  n. 富裕(丰富)
osteopath |  n. 整骨疗法家
overlie |  vt. 放上面(覆盖在...上面,叠加)
photocopier |  n. 复印机
playmate |  n. 玩伴, 游伴
polymeric |  adj. 聚合的，聚合物的
predatory |  adj. 掠夺的, 掠夺成性的, 捕食生物的
preventative |  adj. 预防性的 // n. 预防法
prowess |  n. 英勇,勇敢,超凡技术
realization |  n. 实现,领悟,实得
sawdust |  n. 锯屑
scenario |  n. 情节梗概, 剧本
scrupulous |  adj. 小心谨慎的, 细心的，严谨的
simplistic |  adj. 过分简单化的
splendor |  n. 光辉, 壮丽, 显赫
spreadsheet |  电子表格, 数据表
stratosphere |  n. [气]同温层, 最上层, 最高阶段
substitution |  n. 代理,替换,交换
supersede |  vt. 取代,接替,使放在一边
tectonic |  adj. 筑造的，建筑的，构造的 // 【地】地壳构造的
treacle |  n. 糖浆，过分甜蜜的声调
unravel |  vt.解开； 阐明； 拆散 // vi.被解开； 被拆散
wag |  vt. 摇摆；摇动；饶舌 // vi. 摆动；喋喋不休；蹒跚而行 // n. 摇摆；爱说笑打趣的人
quota |  n. 配额,限额,最低票数
contaminate |  vt. 弄脏,污染
balance |  n. 天平, 平衡, 差额, 平静, 调和, 制衡 // vt. 使平衡, 称重量, 权衡, 抵消 // vi. 建立平衡, 均衡
simulate |  v. 假装,冒充,模仿,模拟
eligible |  adj. 可以选的,有资格的,合格的 // n. 有资格者,合格者,适任者
charity |  n. 慈善机关(团体),仁慈,宽厚
recognize |  vt. 认出,认可,承认,意识到,表示感激
inspiration |  n. 灵感,吸入,鼓舞人心(的东西)
nurture |  n. 养育, 照顾, 教育, 滋养, 营养品 // vt. 养育, 给与营养物, 教养, 扶持
afflict |  vt. 使苦恼,折磨
desirable |  adj. 值得有的,令人满意的,有吸引力的 // n. 有吸引力的人
detect |  vt. 发现,探测信息,侦查 // vi. 当侦探
innocent |  adj. 无罪的, 不懂事的, 无知的, 无辜的
crack |  vt.破裂，打开； （使…）开裂； 说（笑话）； 开瓶 // vi.断裂，折断； 碎裂声，爆裂声； 镜子破裂了； 失去控制，衰退 // n.裂缝； 试图； 缝隙； （可听到响声的）重击 // adj.训练有素的； 技艺高超的； 优秀的； 一流的
tan |  n. 鞣制革,黄褐色 // adj. 黄褐色的,鞣皮的 // vt. 晒黑,鞣(革),鞭打 // vi. 晒成棕褐色
classify |  v. 分类,归类,分等
shrewd |  adj. 精明的
bibliography |  n. (有关某一专题的)书目,参考书目
flexible |  adj. 灵活的,易弯曲的,柔韧的,可变通的
impress |  n. 印象,特徵,印记 // vt. 使...有印象,影响,印刻,传送 // vi. 给人印象
span |  n.共轭（马、骡）； 跨度，墩距； 一段时间； [航] 跨绳 // vt.缚住或扎牢； 跨越时间或空间； 以掌测量； 以手围绕测量类似测量
booming |  adj. 兴旺的, 繁荣的，轰隆作响的
remedy |  n. 药物,治疗法,补救 // vt. 治疗,补救,矫正
discretion |  n. 谨慎,判断力,个人选择,选择的自由 // [计算机] 判定
acoustic |  adj. 美声的，听觉的,音感教育,音响学的
source |  n. 来源
beehive |  n. 蜂箱
calorie |  n. 卡，卡路里(热量单位) // =calory
asymmetry |  n. 不对称
urban |  adj. 城市的
stage |  n. 阶段,舞台,驿站 // v. 上演,表演,乘驿车旅行
application |  n.适用，应用，运用； 申请，请求，申请表格； 勤勉，用功； 敷用，敷用药
temper |  n. 脾气；（钢等）回火；性情；倾向 // vt. 使回火；锻炼；调和；使缓和 // vi. 回火；调和
crater |  n. 弹坑, 火山口
unprejudiced |  adj. 无偏见的, 没有成见的, 公平的
respect |  n. 尊敬, 敬重; 关系, 方面 // vt. 尊敬, 尊重; 关于, 涉及
indicate |  v.指明, 表明, 显示, 象征, 指示
survive |  vt. 比…活得长,幸免于难,艰难度过 // vi. 活着, 继续存在
acrobatic |  adj. 杂技的
afield |  adv. 远离着, 在远处，上战场 // adj. 远离的，偏离的，在战场的
barb |  n. 倒钩 // n. 尖刻、刻薄的言语 // vt. 给...装倒钩
beetle |  n. 甲虫 // n. 大锥，小木槌 // vi. 忙碌地来回，突出，高悬 // adj. 显著的，突出的
beneficiary |  n. 受惠者,受益人
blood clot |  n. 血块，血凝块，血栓
by contrast |  adv. 相反
chaplain |  n. 本堂神父, 专职教士
clear-cut |  adj. 轮廓鲜明的, 清晰的 // n. 林木被伐光的林地 // v. 皆伐
clerical |  n. 牧师 // adj. 书记的, 事务上的, 抄写员的
compete with |  与...竞争
consequential |  adj. 作为结果的(引出重要结果的, 自高自大的)
consumerism |  n. 用户至上主义, 商品的消费和销售性服务
crossbow |  n. 石弓, 弩
discontinue |  v. 中断, 中止, 停止
dispersal |  n. 散布, 传播, 分散，疏散区
dung |  n. 粪 // vt. 上粪
ejection |  n. 喷射，喷出
embezzlement |  n. 盗用, 挪用, 侵占
excusable |  adj. 可原谅的, 可辩解的
fabulous |  adj.极好的，极妙的； （美貌）惊人的； 寓言般的； 难以置信的
fluorescent |  n. 日光灯 // adj. 萤光的
footage |  n. 以尺计算长度, 尺数, 影片的镜头
formality |  n. 礼节,程序,拘谨
gasification |  n. 气化
glaze |  v. 装以玻璃, 上釉, 变得光滑，变呆滞 // n. 釉, 覆罩的一层
grenade |  n. 手榴弹，榴弹
hunch |  n. 肉峰, 预感, 块 // v. 弯腰驼背, 弓起背部, 耸肩
inextricably |  adv. 分不开地
insulation |  n. 隔离, 孤立, 绝缘
leave aside |  vt. 搁置，不考虑
leukemia |  n. 白血病
luxuriant |  adj. 繁茂的, 丰富的, 肥沃的
mesh |  n. 网孔,网丝,陷阱 // vt. 以网捕捉，啮合，匹配 // vi. 适合 // [计算机] 网络
moody |  adj. 易怒的，喜怒无常的,情绪化的 // Moody // n. 穆迪(人名)
murky |  adj. 黑暗的, 朦胧的，烟雾弥漫的，含糊的，隐晦的
organizational |  adj. 组织的
paperclip |  n. 纸夹
patriotic |  adj. 爱国的
perquisite |  n. 额外补贴, 临时津贴
pip |  n. 点，星（肩章符号） // n. 水果的种子，果核 // n. 拨号音 // v. (英）在最后关头被击败 // v. (小鸟等)唧唧喳喳地叫
plough |  n. 犁, 耕地 // v. 用犁耕田, 耕犁
proclaim |  vt. 正式宣布, 公布, 声明, 赞扬, 显示出
projectile |  n. 发射体, 抛射物 // adj. 发射的, 投射的
propose |  v. 计划, 打算, 向...提议; 求婚
pulverize |  v. 磨成粉, 粉碎
puppetry |  n. (总称)木偶，木偶制作(或演出)
pyrotechnic |  adj. 烟火的, 灿烂的 // n. 烟火，烟火中的易燃材料 // =pyrotechnical
racquet |  n. 球拍, 拍球戏之一种, 球拍型雪鞋
realm |  n. 王国,领域
regurgitate |  v. （使）涌回, （使）喷回, （使）流回
rehabilitate |  vt. 改造, 使康复, 使恢复（名誉等）
saber |  n. 军刀 // vt. 用马刀砍 // =sabre（美）
saltpeter |  n. 硝石
saltpetre |  n. 硝酸钾(硝石)
scamper |  n. 蹦跳 // v. 奔跑,快跑 // vi. 涉猎,浏览
scour |  v.冲刷； 擦亮； 四处搜索； （用泻药）泻 // n.擦； 冲刷； 洗涤剂
scrub |  n. 用力擦洗,矮树,渺小之物 // vt.& vi. 用力擦洗
serotonin |  n. 含于血液中的复合胺
showcase |  n. (玻璃)陈列柜, 陈列橱
simplicity |  n. 单纯, 简朴
sizeable |  adj. 相当大的 // =sizable
smoke |  n. 烟, 无常的事物, 抽烟 // v. 吸烟, 以烟熏, 冒烟
sophistication |  n. 老练，精明，复杂，精密，有教养，诡辩, 强词夺理
spiral |  n. 旋涡, 螺旋形之物 // adj. 螺旋形的, 盘旋的 // v. 成螺旋状下降或上升, 成螺旋状旋转
suffragette |  n. 妇女参政权论者
investigate |  vt. &vi. 调查,研究 // [计算机] 研究
scratch |  n. 抓痕,抓的声音,乱写 // vt. &vi. 搔痒,抓,抹掉 // adj. 使皮肤发痒的，潦草的
casualty |  n. 变故,伤亡者,伤亡人数
vanish |  vi. 消失,不见了,绝迹 // vt. 消失
superficial |  adj. 表面的,肤浅的
withdraw |  vt. 撤回,取回,撤退 // vi. 退回,撤退
cooperate |  vi. 合作,协力
Mediterranean |  adj. 地中海(的) // n. 地中海
internal |  adj. 国内的, 内在的，身体内部的
despite |  prep. 不管, 尽管 // v.憎恨, 轻视
landfill |  n. 垃圾堆
quartz |  n. 石英
fertile |  adj. 肥沃的,能繁殖的 // n. 多产,肥沃
subtropical |  adj. 亚热带的
virtue |  n. 美德,优点;贞操
identification |  n. 身份的证明 // n. 视为同一,证明同一,确认
friction |  n. 摩擦,摩擦力,分歧
archive |  n. 档案,档案馆 // vt. 存档
cardiovascular |  adj. 心脏血管的
surge |  n. 汹涌,澎湃 // vi. 汹涌；强烈感到；飞涨 // vt. 放开,松手
worthy |  adj. 有价值的,可尊敬的,值得的,配得上的 // n. 知名人士, 杰出人物
illustration |  n. 插图,例证,说明,图解
screen |  n.屏幕； 银幕； 屏风 // vt.筛（煤、矿石等）； 拍摄； 放映（电影）； 庇护
devastating |  adj. 毁灭性的, 令人震惊的, 强有力的
external |  n. 外部 // adj. 外部的,外用的,客观的,表面的
filter |  n. 筛选,滤波器,过滤器,滤色镜 // vt. &vi. 过滤,渗透 // [计算机] 过滤
spacecraft |  n. 宇宙飞船
dubious |  adj. 怀疑的,可疑的
propel |  v. 推进, 驱使
blend |  vt. &vi. 混合 // n. 混合物
condense |  v. 浓缩, 摘要, 缩短
a vicious circle |  n.(疾病等的)恶性循环,[逻]循环论证
albeit |  conj. 虽然(即使)
aura |  n. 气味, 气氛; n. 光环, 光圈
biltong |  n.干肉片,干肉
bud |  n. 芽, 花蕾 // vi. 发芽, 萌芽 // vt. 使发芽
capsize |  v. 翻覆,倾覆
chronology |  n. 年代学，年表
deregulation |  n. 撤消管制规定
ethereal |  adj. 轻巧的，飘逸的，精致的，飘渺的 // adj. [化学]乙醚的
fraught |  adj. 充满(不愉快事物）的, 伴随的, 忧伤的，忧虑的
hauler |  n. 拖曳者，承运人，运输机，运输工
hundredth |  n. 第一百，百分之一 // adj. 第一百的，百分之一的
immunoglobulin |  n. 免疫球蛋白
incubator |  n. 孵卵器,细菌培养器,早产儿保育器
jigsaw |  n. 缕花锯，竖锯，拼图游戏 // vt. 用竖锯锯，使互相交错搭接
keyhole |  n. 钥匙孔 // adj. 内幕的
ligament |  n. 韧带,结带, 纽带
maturity |  n. 成熟 //  (支票等的)到期
millimeter |  n. 毫米
mishandle |  vt. 粗暴对待，马虎对待
modal |  adj. 模态的
orthopedic |  adj. 整形外科的
ostrich |  n. 鸵鸟；鸵鸟般的人
pliable |  adj. 易曲折的, 柔软的, 圆滑的
pointless |  adj. 不尖的, 钝的, 不得要领的
principal |  adj. 主要的 // n. 负责人, 校长, 资本
prototype |  n. 原型,雏形
reception |  n. 接待,招待会,接收,欢迎,接受
receptionist |  n. 接待员
recommendation |  n. 推荐, 介绍
rental |  n. 地租的,总额,地租收入 // adj. 租借的,地租的
spit out |  吐出
staff room |  教研室
start up |  vi. 惊跳起来(开动,开始工作,突然出现,出发,开办)
swivel |  n. 转换仪器，转体 // vt. 使旋转, 使回旋 // vi. 旋转，回旋
talcum |  n. 滑石，滑石粉
teddy |  n. 泰迪(熊) // n. 妇女连衫裤
theoretically |  adv. 理论上
underpin |  v. 从下头支持, 支撑, 支持
unobtrusive |  adj. 不突出的, 不显眼的, 谦虚的
velocity |  n. 速度, 速率, 迅速
enhance |  vt. 提高,加强,增加
decay |  n. 衰退, 腐败 // v. 衰退, 腐败
chink |  n. 裂缝, （法律上的）漏洞 // n. 硬币，叮当声 // n. （贬）中国人 // v. (使)叮当响 // adj. （贬）中国人
alight |  vi. 落下，走下，偶然发现 // adj. 燃烧的，点亮的
incorporate |  vt.组成公司； 包含； 使混合； 使具体化 // vi.包含； 吸收； 合并； 混合
aerobics |  n. 有氧运动法；增氧健身法
speculate |  vt. 推测,好奇 // vi. 深思,投机
lag |  n. 落后, 滞后, 落后的人, (两事件之间的)时间间隔, 耽搁, 桶盖 // vt. 落后, 投掷, 盖上桶盖, 耽搁 // vi. 走得慢, 落后 // adj. 最后的
studio |  n. 工作场所,画室，照相室，制片厂
inland |  adj. 内陆的, 国内的 // adv. 内陆地 // n. 内陆
chip |  n. 薄片,碎屑，芯片 // vt. 削,切,削成碎片 // vi. 折断成碎片
generate |  vt. 产生,发生,引起 // [计算机] 产生
motivate |  v. 给与动机,刺激,提高...的学习欲望
charge |  n. 电荷, 指控, 费用; 照顾, 责任 // vt. &vi 控诉, 加罪于, 要价, 赊帐, 充电, 管理
regardless |  adj. 不注意的, 粗心的 // adv. 不顾
candidate |  n. 候选人, 求职者
commence |  v. 开始；着手；<英>获得学位
extinct |  adj. 灭绝的,熄灭的 // n. 消灭,熄灭
beverage |  n. 饮料
brochure |  n. 小册子
intensity |  n. 激烈,强度,强烈,剧烈
applicant |  n. 申请人
conceive |  vt. &vi. 构思,以为,怀孕
intellectual |  n. 有知识者,知识份子,凭理智做事者 // adj. 智力的,知性的,聪明的
bounce |  n. 跳,反跃,(活)弹力 // vt. 弹跳,向...透露注意 // vi. 弹起,重新恢复
inductive |  adj. 归纳的,动人的 // adj. [电]感应的
fraction |  n. 分数, 小部分, 破片
spoil |  n. 战利品, 奖品 // v. 宠坏, 溺爱, 破坏, 腐坏
initiative |  adj. 创始的, 初步的, 自发的 // n. 第一步, 首创精神; 主动权
promote |  vt. 促进, 提升, 升迁; 发起; 促销
cast |  n. 演员阵容, 投掷 // v. 投, 掷, 抛
extreme |  adj. 极度的,极端的,尽头的,严重的,末端的 // n. 极端,极限
analogous |  adj. 类似的
aluminum |  n. 铝
arteriosclerosis |  n. 动脉硬化
autonomy |  n. 自治
bureaucratic |  adj. 官僚的，繁文缛节的
cortisol |  n. ［生］皮质(甾)醇
credibility |  n. 可信用, 确实性, 可靠
crusade |  n. 改革运动 // Crusade // n.十字军东征 // vi. 从事改革
curtail |  vt. 缩减, 削减，截短
elixir |  n. 长生不老药, 仙丹妙药
emblazon |  vt. 饰以纹章, 使有光彩，颂扬
encyclopedic |  adj. 百科全书的, 知识渊博的
extravagance |  n. 奢侈, 浪费, 放肆的言行
fairground |  n. 游乐场
frustration |  n. 打破,挫折,顿挫 // [计算机] 失败
flossy |  adj. 华丽的, 时髦的, 丝棉的, 柔软的
glossy |  adj. 光滑的, 有光泽的
glucose |  n. 葡萄糖
hypnotic |  adj. 催眠的, 催眠术的, 易于催眠的 // n. 催眠药, 安眠药, 催眠状态的人
igloo |  n.（爱斯基摩人用冰雪凝块砌成的）拱形圆顶小屋
incongruous |  adj. 不协调的, 不一致的, 前后不一的
infirmity |  n. 虚弱, 病身, 疾病，弱点
insulin |  n. 胰岛素
intermix |  v. 混入, 混杂
introductory |  adj. 介绍的, 引导的, 开端的
manipulative |  adj. 用手处理的,巧妙处理的,窜改的
maternal |  adj. 母亲的, 母系的, 母方的
meagre |  adj. 瘦的, 不足的, 贫乏的 // =meager(美)
mimetic |  adj. 模仿的
mimic |  vt. 模仿，摹拟 // n. 效颦者，模仿者；仿制品；小丑
nomadic |  adj. 游牧的, 游牧民族的, 流浪的
numeration |  n. 记数, 计算
onslaught |  n. 突击, 猛击, 猛攻
pancreatic |  adj. 胰脏的
paramount |  adj. 极为重要的 // Paramount. 派拉蒙(美电影公司)
precarious |  adj. 不确定的, 危险的
punctual |  adj. 严守时刻的,准时的,正点的
recalcitrant |  adj. 反抗的, 反对的, 顽强的 // n. 反抗的人, 顽强者
referendum |  n. 公民投票,普通投票,请示书
regimen |  n. 养生法, 生活规则,训练课程，统治，制度
remuneration |  n. 报酬,赔偿,补偿
reprint |  vt. 再版, 重印 // n. 再版，重印本
retrenchment |  n. 减少，删除
sanction |  n. 核准,处罚,约束力 // v. 制定制裁规则,认许,核准
squirrel |  n. 松鼠, 松鼠皮毛 // vt. 储存
statistical |  adj. 统计的, 统计学的
suffice |  vi. 足够,合格 // vt. 使...足够
triglyceride |  n. 甘油三酯
umbrella |  n. 伞,保护伞 // vt. 用伞遮住
unaided |  adj. 未受协助的，独立的
unwrap |  vt. 打开，展开
voluntarily |  adv. 自动地, 以自由意志
tremendous |  adj. 巨大的, 惊人的
liberty |  n. 自由；许可；冒失
perpetual |  adj. 永恒的,永久的,一再往复的
claim |  n. 要求,要求权;主张,断言,声称;要求物 // vt. 要求,请求；主张,声称,断言
cancel |  n. 取消,撤消 // vt. 取消,删去, 约分 // vi. 抵消
deteriorate |  vt. (使)恶化 // vi. (使)恶化, 瓦解, 衰退
immense |  adj. 巨大的,广大的,非常好的
appraisal |  n. 估计,估量,评价
fossil |  adj. 化石的 // n. 化石,食古不化的人,过时的词
terminal | n. n. 终端机,终点,末端 // adj. 终点的,晚期的,致死的
viable |  adj. 能生存的,可行的,能居住的的
equator |  n. 赤道
bronchitis |  n. 支气管炎
compulsory |  adj. 被强制的,强迫的,义务的
tolerate |  v. 忍受,容忍,容许,宽恕 // vt. 容忍,忍受,容许
scheme |  n. 方案, 计划, 阴谋 // v. 计画, 设计, 体系, 结构, 图谋
athlete |  n. 运动员
naive |  adj. 天真的,幼稚的
emergency |  adj. 紧急的 // n. 紧急情况,突发事件
complain |  vi. 抱怨,悲叹,控诉
format |  n. 设计,版式 // n.[计算机]格式,DOS命令 : 格式化(磁盘),用于空盘或使用过的磁盘建立新空盘来存储数据 // v. vt.使格式化,设计,安排
venture |  n. 冒险,风险,投机 // vt. 敢尝试,谨慎地做，冒险一试 // vi. 冒险做
process |  n.过程； 工序； 做事方法； 工艺流程 // vt.加工； 处理； 审阅； 审核 // vi.列队行进 // adj.经过特殊加工（或处理）的
controversial |  adj. 引起争论的,有争议的
depict |  vt. 描述,描绘
definite |  adj. 明确的,一定的
dizzy |  adj. 晕眩的, 傻的, (速度)极快的, 困惑的 // vt. 使困惑, 使晕眩
fatal |  adj. 致命的, 毁灭性的, 决定性的
conjunction |  n. 连词, 结合, 关联,(事件等的)同时发生
notorious |  adj. 臭名昭著的
abdomen |  n. 腹部
allocation |  n. 配置, 分配, 安置
alternatively |  adv. 二者择一地, 做为选择
analogy |  n. 相似,类似，类比
asbestos |  n. 石棉
biographer |  n. 传记记者
buffet |  n. 打击, 饮食柜台, 自助餐 // vt. 打击, 连续猛击 // adj. 受到非正式接待的(如同冷餐会般随意的)
built-in |  adj. 嵌入的，内装的 // n. 嵌入式，内置
candle wax |  烛用蜡
cinematographer |  n. 电影摄影技师, 放映技师
circumscribe |  vt. 在...周围画线, 限制
couple |  n. 对, 夫妇, 数个 // v. 加倍, 成双, 连结
descend from |  vt. 起源于，由 ... 传下来的
discrepancy |  n. 相差,差异,差别
disjunction |  n. [计]析取, 分离, 分裂
elucidate |  v. 阐明, 说明
excavation |  n. 挖掘, 发掘, 挖掘的洞，发掘物，遗迹
filler |  填充符
forgo |  v. 没有...就算了, 作罢停止, 放弃
foyer |  n. 门厅, 休息室
gallop |  n. 疾驰,飞奔 // v. 飞驰,急速进行,急急忙忙的说
garret |  n. 阁楼, 顶楼, 头
granular |  adj. 由小粒而成的, 粒状的
headphone |  n. 头戴式收话器, 双耳式耳机
heroic |  adj. 英雄的,英勇的 // (措施等) 冒险的; (药物) 剂量大的, 猛烈的
hexa |  pref. 六
hoof |  n. 蹄,人的脚 // v. 以蹄踢,行走,步行
incongruity |  n. 不调和, 不一致, 不配合
judo |  n. 柔道
line |  n. 行,线,航线,场界,皱纹,家族 // vt. &vi. 用做衬里,排成一行,顺...排列 // vi. 排成一行,顺...排列,划线于
lunatic |  adj. 疯狂的，极蠢的 // n. 疯子
malevolent |  adj. 有恶意的, 恶毒的
malleable |  adj. 可塑的, 易改变的
marshland |  n. 沼泽地
mass media |  n. 大众传播媒体，海量媒体数据，新闻界
meteorological |  adj. 气象的
mucky |  adj. 粪的, 肮脏的
obscurity |  n. 阴暗,不分明,身份低微
orthography |  n. 正确拼字, 拼字, 正字法
patronage |  n. 赞助, 光顾, 任免权
pedigree |  n. 家谱，系谱，血统，(动物的)种  // adj. 纯种的
penetration |  n. 渗透,侵入,突破,
phenol |  n. 黝分, 石碳酸
predecessor |  n. 前辈, 前任, 原有事物
psychiatrist |  n. 精神病医师, 精神病学家
psychic |  adj. 灵魂的, 精神的, 心灵的, 通灵的 // n.通灵的人
pterosaur |  n. 翼龙
queue |  n. 行列,长队 // v. 排队 // vi. 排长队
redevelopment |  n. 再发展
renaissance |  n. 文艺复兴,再生
rickety |  adj. 患软骨病的, 驼背的, 摇摆的
scuffle |  vi. 混战, 扭打，拖脚行走 // n. 混战
sew |  vt. 缝纫,缝合 // vi. 缝纫
skepticism |  n. 怀疑论, 怀疑态度, 怀疑主义
stuffy |  adj. (房间等)不通气的, (人或事物)沉闷乏味的, 自负的
thermoplastic |  adj. 热后可朔性的 // n. 热后可朔性物质
thermosetting |  adj. 热硬化性的
tortoiseshell |  n. 龟甲, 玳瑁, 蛱蝶, 花斑家猫 // adj. 龟甲的, 杂黄褐色的
whilst |  conj. 当...时, 可是, 虽然,只要
wing |  n. 翅膀,翼 // vt. 给...装上翼,飞行 // vi. 飞行
writhe |  vt. 挣扎, 痛苦地扭曲 // vi. 扭曲，翻腾，受苦 // n. 翻腾, 苦恼
incur |  v. 招致,蒙受,遭遇
flap |  n. 拍打，拍打声；襟翼 // vt.& vi. 拍打,鼓翼而飞,飘动
cholesterol |  n. 胆固醇
adjust |  vt. 调整, 使...适于 // vi. 适应
limitation |  n. 限制
notable |  adj. 显著的, 著名的 // n. 名人
degrade |  vt. 贬低；使……丢脸；使……降级；使……降解 // vi. 降级，降低；退化
acknowledge |  vt. 承认,公认,告知收到,表示感谢,注意到
infection |  n. 传染, 影响, 传染病
dissolve |  vt. 消除,解散,使溶解,解决(问题),使沮丧 // vi. 消散,溶解, 解散, 液化,变得模糊 // n. 叠化画面
surpass |  vt. 超越,凌驾,胜过
Mercury |  n. 水银, 水星
concession |  n. 让步, 妥协, 特许权
valid |  adj. 有确实根据的; 有效的; 正当的, 合法的
fascinating |  adj. 迷人的
nourish |  v. 滋养, 使...健壮, 怀有
flexibility |  n. 灵活性, 柔韧性，适应性
viscous |  adj. 粘的,有粘性的,粘性的
guidance |  n. 引导,指导,导航系统
invest |  vt.& vi.投资； 花费 // vt.授予，使就职； 给…穿衣，装饰； 使充满； 覆盖
eject |  vt.喷出； 驱逐； 强制离开 // vi.弹射出
assume |  vt. 假定, 设想, 承担; (想当然的)认为
refresh |  vt.& vi. 使...生气蓬勃,提起精神,恢复精神
wildlife |  n. 野生动物
monopoly |  n. 垄断,专利, 独占，控制
entrepreneur |  n. 企业家
in accordance with |  adj. 按照(根据, 与...致, 合乎, 和-一致)
variability |  n. 易变, 变化性, 变异性
flourish |  vi. 繁荣,茂盛,活跃,手舞足蹈 // vt. 挥舞 // n. 挥舞,华丽词藻,茂盛,兴旺,炫耀
remain |  v. 保持, 依然, 剩余, 留下, 逗留 // n. 遗迹, 剩余物, 残骸
compatible |  adj. 能共处的,可并立的,适合的, 兼容的 // n. 兼容
highlight |  n. 加亮区,精彩部分, 最重要的细节或事件, 闪光点 // vt. 加亮,强调, 使...显得重要, 照亮 // [计算机] 醒目
accredited |  adj.被认可的，可接受的，委任的 // 动词accredit的过去式和过去分词
alpha |  n. 希腊字母的第一个字母，最初，开端 // adj. [化]阿尔法位的，主导的，首要的，按字母顺序的
backlash |  n. 后冲, 反撞, 激烈反应, 强烈反对, 缠结, 齿轮隙
camouflage |  v. 伪装, 欺瞒
cipher |  n. 零, 暗号，阿拉伯数字，密码 // vi. 计算, 做算术 // vt. 将...写成密码
comma |  n. 逗号，停顿，间歇 // n. 银纹多角蛱蝶
configuration |  n. 结构,布局,形态,格式塔心理完形 // [计算机] 配置
culprit |  n. 犯人,罪犯,刑事被告,肇事者,罪魁祸首
curator |  n. 管理者(馆长)
cybernetics |  n. 控制论
disorientate |  vt. 使 ... 失去方向感，使 ... 神志迷乱 // =disorient
encapsulate |  v. 装入胶囊, 封进内部, 压缩
encyclopedia |  n. 百科全书
eventuality |  n. 不测的事, 可能发生的事
firefly |  n. 萤火虫
germinate |  v. 发芽, 萌芽, 开始发育 // v. 使发芽, 使发达
horticulture |  n. 园艺学
hypothetical |  adj. 假设的, 假定的, 爱猜想的
lozenge |  n. 菱形, 菱形花纹, [医]锭剂
mathematical |  adj. 数学的，精确的，可能性极小的
monograph |  n. 专题论文
mystical |  adj. 神秘的 // adj. 神秘主义的 // adj. 有心灵象征意义的
oxygenate |  v. 以氧处理, 氧化 // n. 氧化剂
perennial |  adj. 四季不断的, 继续多年的，永久的 // n.多年生植物
perpetuate |  vt. 使永存,使不朽
photoperiod |  n. 光周期
photoperiodism |  n. 光周期现象(光周期性)
photosynthesis |  n. 光合作用
propagate |  vt. &vi. 繁殖,扩增,传播,传送
Pueblo |  Pueblo: n. 普艾布罗(美国科罗拉多州中部一城市) // pueblo: n. 普埃布洛族，普埃布洛人
refundable |  adj. 可退费的，可偿还的
reinvigorate |  vt. 使再振作，使复生
shard |  n. 碎片(薄硬壳)
slumber |  n. 睡眠，微睡，休止状态 // v. 睡觉, 打盹, 静止，休眠
snapshot |  n. 快照，印象
solidify |  vt. 使牢固，使团结 // vi. 变坚固，变结实
somatotropin |  n. [生化]生长激素
sugarcane |  n. 甘蔗
tensile |  adj. 可拉长的, 可伸展的,张力的
travelogue |  n. 游记，旅行见闻，观光影片 // =travelog
treatise |  n. 论文, 论述
tuition |  n. 教诲,教学,学费
tundra |  n. 苔原, 冻土地带
unbeatable |  adj. 竞争不过的，无法与之竞争的，无敌的
commodity |  n. 商品, 日用品
capsule |  n. 荚膜, 胶囊, 简缩, 太空舱 // vt. 装入胶囊, 简缩, 概括 // adj. 精简的, 小巧的
venue |  n.犯罪地点,审判地,管辖地,发生地点,集合地,体育场馆
decipher |  vt. 译解
humble |  adj. 卑下的, 谦逊的, 粗陋的 // vt. 使...卑下, 贬低
bizarre |  adj. 奇异的,怪诞的 // n. 奇异花
residential |  adj. 住宅的,与居住有关的
obligation |  n. 义务, 责任
accelerate |  vt. 加速,提前,跳级 // vi. 加速
in addition |  adv. 另外,此外
unique |  adj. 独一无二的, 独特的, 稀罕的
interplay |  n. 相互影响
advance |  n. 前进,进步,预支 // vt. 前进，增涨，预先 // vi. 前进，提升 // adj. 预先的，提前的
luxury |  n. 奢侈, 豪华, 奢侈品
disagree |  v. 不一致, 有分歧，不适应，不适宜
skim |  vt. 撇去浮沫,略读,掠过,滑过 // vi. 掠过,覆盖了一层浮沫,侵吞钱财 // n. 一层浮沫,略读,脱脂物 // adj. 撇去浮沫的,由脱脂乳做的
unconquerable |  adj. 不可征服的，克服不了的，压抑不住的
sociology |  n. 社会学, 社会关系学, 群落生态学
regulate |  v. 有系统的管理,规定,调节
concern |  vt. 涉及, 影响, 关心 // n. 关心, 忧虑, 关心的事; 公司, 企业
influenza |  n. 流行性感冒
decorate |  vt. 装饰, 装修, 授予某人奖章或其他奖状
volunteer |  n. 志愿者,自行生长的植物 // adj. 志愿的,自行生长的(树等) // vt. &vi. 自愿(做)
substance |  n. 物质,实质,内容,重要性,财产
prescription |  n. 药方, 对策, 开处方
ensure |  vt. 确定,保证,担保
establish |  v. 建立, 确立, 创办
lexicographer |  n. 辞典编纂者
excursion |  n. 远足, 短途旅行
batch |  n. 一次所烘的面包,一次所制之量,一组, 批, 分批 // vi. 分批处理
shareholder |  n. 股东，股票持有人
nevertheless |  adv. 仍然, 不过 // conj. 然而, 不过
amorphous |  adj. 无定形的, 无组织的，非结晶的
anatomical |  adj. 结构上的, 解剖(学)的
bale |  n. 包, 捆, 货物 // n. 灾祸，不幸，悲痛 // v. 将...打包, 捆包, 包装
cancellation |  n. 取消
centrifugal |  adj. 离心的
chrysalis |  n. 蛹, 茧, 准备期
coachload |  n. 乘坐长途汽车旅行的一群人
colossal |  adj. 巨大的,异常的
commentator |  n. 注释者(注释者,解说员,新闻广播员)
consignment |  n. 委托 // adj. 委托的
coursework |  n. 课程作业
disillusionment |  n. 幻灭感
floral |  adj. 花似的, 花的, 植物的 // n. 以花占主要的图片或设计
individualistic |  adj. 个人主义的
inventive |  adj. 善于创造的, 发明的
liaise |  vi. 保持连络,担任连络员
matchstick |  n. 火柴
muddle |  n. 困惑, 混浊状态 // vt.使混乱，使糊涂, 使惊呆 // vi. 胡乱应付，混乱
newsletter |  n. 时事通讯, 时事分析, 时事传报
niggle |  v. 挑剔，吹毛求疵，惹恼 // n. 怀疑，抱怨
objectify |  vt. 使具体化，使客观化
oddly |  adv. 奇妙地,奇怪地,单数地
office |  n. 办公室，职务，事务
phosphorus |  n. 磷
pollinate |  v. 给...授粉 // vt. 授以花粉
polystyrene |  n. [高分子] 聚苯乙烯
porcelain |  n. 瓷器,瓷 // adj. 瓷制的, 精美的, 脆的
prefabricate |  vt. 预先建造组合
preposition |  n. 介词
pretension |  n. 自命不凡；虚荣；矫饰；声称；标榜；自称
prospectus |  n.内容说明书； （即将出版的书等的）内容介绍，简介； 计划书，意见书； （讲义等的）大纲
protrude |  v. 使突出，伸出,突出
provenance |  n. 出处, 起源
provisional |  adj. 暂时的 // n. 临时性,临时人员
radius |  n. 半径,桡骨,半径范围,辐射区
recapture |  n. 取回, 夺回 // vt. 拿回, 夺回, 再经历，再俘获
rediscovery |  n. 重新发现
requirement |  n. 要求,必要条件
sledge |  n. 雪橇, 大锤 // v. 用雪橇搬运, 坐雪橇往
smolder |  vi. 无火焰地闷烧, 压抑
studious |  adj. 爱好学问的,努力于...的,热心的
trap |  n. 圈套,陷阱,困境,双轮轻便马车  // vt. &vi. 设圈套,设陷阱
treasurer |  n. 会计, 出纳员，司库
unemployment |  n. 失业,失业人数
splendid |  adj. 辉煌的；灿烂的；极好的；杰出的
feasible |  adj. 可行的,可能的
sufficient |  adj. 足够的, 充分的
chain |  n. 链,连锁,束缚 // vt. 用铁练锁住,束缚,囚禁
fundamental |  adj. 基本的,根本的,重要的 // n. 基本原理,基础
impose |  vi. 利用；欺骗；施加影响 // vt. 强加；征税；以…欺骗
democratic |  adj. 民主的, 大众的, 平等的
contrary |  adj. 相反的,截然不同的 // adv. 相反(地) // n. 反面,相反
explorer |  n. 探测者
define |  vt. 定义, 解释
overall |  adj. 全部的, 全体的, 一切在内的 // adv. 总的来说, 全部地 // n. 防护服，罩衫
award |  vt.授予，奖给，判给； 判归，判定 // n.奖品； （仲裁人、公断人的）裁定； （法院、法官的）判决； 裁定书
betray |  vt. 误导,出卖,背叛,泄露 vi. 证明...错误
hamster |  n. 仓鼠
attribute |  n. 属性, 特征; 标志, 象征 // vt. 归于, 属于
outline |  n. 大纲,轮廓,概要,略图,素描 // vt. 描画轮廓,描述要点
inherent |  adj. 内在的, 固有的
durable |  adj. 耐用持久的 // n. (复)耐用品
economic |  adj. 经济学的, 经济的，有利可图的 // n. [-s]经济学(状况等)
adhere |  vi. 坚守于, 对...忠贞, 紧抓着, 遵守 vt. 使附着, 使粘牢
whereas |  conj.&amp;adv. 然而,却,反之
ignorance |  n. 无知
concentrate |  vt.& vi.专心于； 注意； 集中； 聚集 // vt.浓缩，（使）浓缩； [采矿]汰选； 选矿，精选，富集 // vi.凝缩，浓缩，提纯 // n.浓缩物 // adj.集中起来的，经过浓缩的
document |  n. 文件,公文 // vt. 记载,用文件等证明 // [计算机] 文档
responsible |  adj. 有责任的,负责的,责任重大的,应负责的
shaft |  n. 轴,杆状物 // vt. 装杆于,利用
leopard |  n. 豹
predispose |  v. (使)易罹患, (使)预先偏向于
dissertation |  n. 论文
reproduce |  v. 再生, 复制, 生殖
germ |  n. 微生物, 细菌
consequence |  n. 结果,后果
invalid |  adj. 无效的,伤残的 // n. 病人,残疾者 // vt. 失去健康
discipline |  n. 训练, 纪律, 惩罚; 学科 // vt. 训练, 惩罚
affinity |  n. 姻亲,密切关系,吸引力
aroma |  n. 浓香, 香气
attendance |  n. 出席,出席人数,出席率
authenticate |  v. 证明(某物)为真
autoimmune |  adj. 自身免疫的
biometric |  adj. 计量生物学的 // =biometrical
botanist |  n. 植物学家
caustic |  adj. 腐蚀性的, 刻薄的，[物]焦散的 // n. 腐蚀物，[物]焦散曲面
churn |  n. 搅乳器 // v. 搅拌, 搅动
coalesce |  v. 合并, 联合, 接合
credential |  n. 凭证 // adj. 证明可信任的 // v. 授以证书
detergent |  n. 清洁剂 // adj. 用于清洗的
disempower |  剥夺；使失去权利, v. disempower,取走权力和影响力
disruptive |  adj. 捣乱的, 破坏性的, 制造混乱的
divisional |  adj. 分划上的, 区分的, 分区的, 部门的
documentation |  n. 文件
factual |  adj. 事实的, 真实的
forerunner |  n. 先驱，祖先，预兆，[体育]赛前试滑滑道的人
genome |  n. [生]基因组, 染色体组
helium |  n. 氦
hemoglobin |  n. 血红蛋白
herd |  n. 兽群,人群,牧人 // vt. 群集,使...成群,放牧 // vi. 聚在一起
inductee |  n. 就任者，应召入伍的士兵
magenta |  n.&amp;adj. 紫红色(的染料)
managerial |  adj. 管理的
miscellaneous |  adj. 各种的,多方面的,性质混杂的 // [计算机] 杂的 // n. 杂货，杂项 // [合同法律用语]其他约定
notoriety |  n. 臭名昭著, 恶名, 声名狼籍
odor |  n. 气味,名声,气息
outcrop |  n. 露出, (岩石）露头 // vi. 露出（地表）, 出现
peevish |  adj. 易怒的, 暴躁的, 撒娇的
periphery |  n. 周边(边缘,圆周,圆柱体表面)
periscope |  n. 潜望镜
permeate |  v. 弥漫, 渗透, 普及
plagiarism |  n. 剽窃,剽窃物
prerequisite |  n. 先决条件 // adj. 作为前提的, 必备的
proxy |  n. 代理,代理人,取代物 // adj. 代理的
recreational |  adj. 休养的, 娱乐的
reduction |  n. 减少,缩小, (化学)还原反应, (数学)约分
reel |  n. 卷筒,线轴 // vi. 蹒跚地走,旋转,骚乱,退缩,摇晃 // vt. 卷,卷...于轴上, 旋转
registration |  n. 登记,注册,挂号
rheumatoid |  adj. 患风湿病的
rubric |  n. 种，类，题目，标题，注释，书或稿件中用特殊字体颜色（如红色）标出的内容，成规，习俗 // adj. 红色的，用红色写的
stigmatize |  vt. 污蔑，使蒙上污名  // vt.  打上烙印
subterranean |  adj. 地下的，隐蔽的
suburbia |  n. 郊区, 郊区居民
tranquility |  n. 宁静，平静，稳定
trench |  n. 沟, 沟渠 // v. (挖)沟, (挖)战壕
trolley |  n.手推车； 触轮； 电车，有轨电车； 空中吊运车 // vt.&vi.载运用有轨电车运送（乘客）； 乘电车
verification |  n. 确认, 查证, 作证
reserve |  n. 预备品, 贮存, 候补 // n. 克制, 含蓄 // vt. 保留, 预订, 延期
decrease |  n. 减少(量),降低 // vt.& vi. 减少,降低
terrain |  n. 地带,地域,地形
souvenir |  n. 纪念品
fierce |  adj. 猛烈的, 凶猛的, 残暴的, 强烈的
cluster |  n. 串,丛,群 // v. 聚合,成串,丛生,使...聚集
intensive |  adj. 强烈的, 密集的, 精细的, 强调的 // n. (语法)强调成份
hinterland |  n. 海岸的后部地方(穷乡僻壤)
violent |  adj. 暴力的,猛烈的,极端的,曲解的
presentation |  n. 陈述, 介绍, 赠与 // n. [美]讲课, 报告
reputation |  n. 声誉,好名声
materialistic |  adj. 唯物论的, 唯物主义的
determine |  vt.& vi.（使）下决心，（使）做出决定 // vt.决定，确定； 判定，判决； 使决定； 限定 // vi.[主用于法律]了结，终止，结束
chorus |  n. 合唱队,歌舞队，齐声说道，副歌部分， // vt. 合唱
challenge |  n.挑战； 盘问； 质疑； 怀疑 // vt.质疑； 向…挑战 // vi.提出挑战，要求竞赛（或竞争）； 驳斥
resident |  adj. 居住的 // n. 居民,旅客
beforehand |  adv. 预先, 事先
mutual |  adj. 共同的,相互的
disorder |  n. 杂乱,混乱 // vt. 扰乱
impair |  vt. 损害,削弱 // [计算机] 损伤
counsel |  n. 商议, 忠告, 法律顾问 // v. 商议, 劝告
stationary |  adj. 不动的(稳定的) // n. 固定物(驻军)
emotion |  n. 情感,情绪,感动
prescribe |  vi. 规定,开药方 // vt. 规定,命令,开处方
shipment |  n. 装船,货物,出货
tap |  n. 轻打, 水龙头, 电话窃听 // vt. 从...放出液体, 自...某人处获取, 在...上装窃听器, 轻拍 // vi. 轻拍
justice |  n.正义； 公正； 法律制裁； 审判员，法官
recycle |  vt. 使再循环,再利用,再制 // vi. 循环 // n. 再循环
dispute |  n. 争论; 争吵 // vi. 争论, 争执 // vt. 争论; 质疑; 争夺; 抵抗
clip |  n. 夹子,别针,回形针,修剪,剪下来的东西 // vt. &vi. 修剪,剪报,痛打,紧紧围住
alchemist |  n. 炼丹术士
eliminate |  v. 除去,排除,剔除 // [计算机] 消除
acclimatization |  n.适应气候(驯化作用)
accountability |  n. 有责任, 有义务
biochemistry |  n. 生物化学
bolt |  n. 门闩,突发,螺钉,剑弩,闪电 // vt. 闩住,,用螺栓固定在一起,狼吞虎咽 // vi. 冲出去,急逃 // adv. 背部挺直地坐或站
botanical |  adj. 植物学的，植物的 // n. 植物制剂
cabinet |  n. 橱柜,内阁 // adj. 私人的
centerpiece |  n. 中心装饰品, （餐桌）中央的摆饰
cocaine |  n. 可卡因
compatibility |  n. 和谐共处, 兼容
count |  v. 计算, 视为, 依赖 // n. 计数
dampen |  v. (使)潮湿, 使沮丧, 泼凉水
deleterious |  adj. 有害的, 有毒的
disparate |  adj. 不同的, 全异的, 乖离的
effluent |  adj. 流出的 // n. 流出物,由河,湖等流出之水流
elitism |  n. 精英主义, 优秀人士统治
extroversion |  n. [心理]外向，[医]外翻 // =extraversion
fabricate |  vt. 制造；伪造；装配
gigabyte |  n. 千兆字节
graphics |  n. 制图法,制图学,图表算法 // n.[计算机]图形学,DOS命令 : 允许使用Shift-PtrSc键打印屏幕图形
guzzle |  v. 牛饮, 暴食, 喝酒失控
harness |  n. 马具,系在身上的绳子,甲胄 // vt. 束以马具,披上甲胄,利用(产生动力)
hydrate |  n. 水化物 // v. （使）水合
inherit |  vi. 继承 // vt. 继承,遗传
insinuate |  vt. 暗示，迂回进入 // vi. 迂回进行
jellyfish |  n. 水母, 海蜇, 意志薄弱的人
laid-back |  adj. 松驰的，懒散的
laptop |  n. 便携式电脑, 笔记本电脑
lesser |  adj. 较少的, 较小的, 次要的
lush |  adj. 苍翠繁茂的, 多青草的, 丰富的
milligram |  n. 毫克
miniscule |  adj. 草写小字的，小字的 // =minuscule
neurone |  n. 神经细胞, 神经元 // =neuron（美)
photovoltaic |  adj. 光电池的(光致电压的,光生伏打的)
plaque |  n. 匾, 饰板, 名牌, 徽章；血小板
plummet |  n. 铅锤,铅垂线 // vi. 垂直落下,暴跌
possession |  n. 财产, 所有, 拥有
proliferate |  v. 增殖，增生, 使...激增, 使...扩散, 迅速扩大
protocol |  n. 草案, 协议,礼仪 // vt 拟定议定书
quotation |  n. 1．引语,语录 //  2．报价单 //  3．行情表
quote |  n. 引用 // v. 引述, 举证, 报价
rappel |  vi. 绕绳下降 // n. 绕绳下降
renewal |  n. 更新, 革新, 复兴, 复活
sewer |  n. 下水道, 阴沟, 裁缝师
stand |  n. 站立,停顿,楼台,货摊 //  // vi. 站立,位于，停滞 //  // vt. 忍受,使站立
statutory |  adj. 法令的, 法定的, 触犯法令的
sword |  n. 剑,刀, 致命或毁灭性器械, 剑状物,使用武力, 军事裁判权
tenant |  n. 房客,佃户 // vt. 居住
tentacle |  n. (动物)触角, 触须
toaster |  n. 烤面包机
typology |  n. 类型学,预示论, 标示说
undisputed |  adj. 无可置辩的, 无异议的, 确实的
venison |  n. 鹿肉，野味
weird |  adj. 怪异的，离奇的 // n.命运；预言者
livestock |  n. 家畜, 牲畜
phenomenon |  n. 现象, 非凡的人或事物
intelligent |  adj. 聪明的, 智能的
affect |  vt. 影响, 作用, 感动
opponent |  n. 对手, 敌手, 反对者 // adj. 敌对的, 反对的
distinctive |  adj. 有特色的,出众的
waist |  n. 腰, 腰部
migrate |  v. 移动,移往,随季节而移居 // [计算机] 迁移
shelter |  n. 庇护所,避难所,庇护 // vt. &vi. 庇护,保护,隐匿
bypass |  vt. 绕开, 忽视 // n. 支路，旁道
status |  n. 地位, 身份, 情形, 状况
adventure |  n. 冒险,奇遇 // vt. 冒险,尝试 // vi. 大胆进行,冒险
relieve |  vt. 减轻,救济,解除
apply |  vt. 应用, 申请; 涂 // vt. 使专心从事 // vi.申请; 有关联
identity |  n. 身份,一致，特征
yield |  n. 生产量, 投资收益 // v. 生产, 屈服, 投降, 弯下去, 凹下去
pension |  n. 退休金,年金,抚恤金 // v. 发给退休金
litter |  n. 垃圾, 杂乱，一窝(幼仔)，褥草，轿子 // v. 乱丢垃圾, 弄乱，产(幼仔)，用草等给动物铺窝
register |  v. 记录, 登记, 注册, 挂号 // n. 暂存器, 记录, 登记簿 // n. (语)语域; 通风调节设备
splint |  n. 薄木片, 托板, 夹板
dystrophy |  adj. 营养不良的(萎缩)
ape |  n. 猿
category |  n. 种类, 类别
location |  n. 地点,位置
burglar |  n. 窃贼
involve |  vt. 包含, 使陷入, 使忙于, 使卷入, 牵涉
epidemic |  n. 传染病, 流行病 // adj. 流行的, 传染性的
principle |  n. 原则, 原理, 主义, 信念
interdependent |  adj. 相互依赖的, 互助的
symptom |  n. 症状, 征兆
authority |  n. 权威；权力；当局
equivalent |  adj. 等价的, 相等的 // n. 相等物
hypothesis |  n. 假设, 猜测, 前提
antiseptic |  n. 杀菌剂, 防腐剂 // adj. 杀菌的, 防腐的，极为干净整洁的，冷漠的
assertion |  n. 断言,主张
astrology |  n. 占星术, 占星学
axis |  n. 轴,中枢
baggy |  adj. 宽松的
blockbuster |  n. 轰动, 巨型炸弹
canyon |  n. 峡谷
concentric |  adj. 同中心的, 同轴的
cosmic |  adj. 宇宙的，广大无边的，无限的
crescent |  n. 新月, 新月形之物 // adj. 新月形的, 逐渐增加的
demolition |  n. 破坏,毁坏 // (复数)demolitions：炸药
denizen |  n. 居民，栖息者，外籍居民，外来动植物，老主顾
disinfect |  vt. 消毒，杀菌
divergent |  adj. 分歧的
dynamism |  n. [哲]物力论, 力本说
examiner |  n. 主考者，审查员
extenuate |  v. 企图减轻(罪行等); 为...找借口
flare |  n. 闪光, 闪耀, [天]耀斑 // v. 闪光, 闪耀
flicker |  n. 闪烁, 闪光, 颤动 // v. 闪动, 闪烁, 摇动
flint |  n. 打火石, 极硬的东西
functionality |  n. 功能（尤指软件、硬件、机械或设备的功能），功能性
gimmick |  n. 暗机关，小发明，花招，噱头 // vt.用暗机关改变或影响
glitter |  n. 灿烂, 闪烁, 辉耀 // v. 灿烂, 闪烁, 辉耀
graph |  n. 图表,曲线图 // v. 图表,用图表表示 // vt. 以(曲线)图表示
gravitation |  n. [物]万有引力
hard-pressed |  adj. 经济拮据的，被催逼的，经历大困难的
homogenization |  n. 均化作用
imprisonment |  n. 监禁, 关押，拘禁
increasingly |  adv. 逐渐地, 渐增地
infinitesimal |  adj. 极小的,极微的,无限小的 // n. 极小量,极微量,无限小
infinity |  n. (时间,空间等)无限,无穷，[数]无穷大
interior |  adj. 内部的,内地的,国内的,在内的 // n. 内部
manifold |  n. 复印本,多种 // adj. 多种的,有许多部份的,多方面的 // v. 复写,繁殖,增多
mirage |  n. 海市蜃楼, 幻想
mishap |  n. 不幸之事, 灾祸, 恶运
mountainous |  adj. 多山的，如山一般的
offer |  n. 出价, 提议 // vt. 提供, 出价; 贡献, 奉献 // vi. 提议; 出现; 求婚
outpatient |  n. 门诊病人
pervade |  v. 弥漫, 遍及, 漫延
plasma |  n. 等离子体(血浆,深绿玉髓)
pounce |  n. 猛扑，袭击 // n. (猛禽的)爪 // n. 吸墨粉 // vi. 猛扑, 突然袭击 // vt. 撒吸墨粉，用印花粉印
precedence |  n. 优先, 居先
pretentious |  adj. 自负的, 自命不凡的，炫耀的
prick |  v. 刺, 穿, 受责备 // n. 扎, 逗点, 锥
profoundly |  adj. 深深地,深远地,非常地 // adv. 深深地
proprietor |  n. 所有人,业主,经营者
raze |  vt. 摧毁，消除, 抹去
retiree |  n. 退休人员，退休者
rite |  n. 仪式, 典礼
slop |  v. 溢出，溅出，用（剩饭）喂 // n. 淌出或溅出的液体，烂泥，流食，剩饭，排泄物 // (复数)slops:(水手的)衣服，罩衣
sneaker |  n. 鬼鬼祟祟做事的人, 卑鄙者, 运动鞋
subsoil |  n. 下层土, 底土 // vt. 翻起 ... 的底土
surfer |  n. 冲浪者
sweatshirt |  n. 运动衫
temporal |  adj. 当时的,暂时的,现世的 // n. 世间的事物
topsoil |  n. 表层土 // vt. 去掉表土
trainee |  n. 练习生, 新兵, 训练中的动物
transfusion |  n. 倾注(灌输, 渗透, 转移, 输)
undervalue |  vt. 低估价值，看轻
uphill |  adv. 上坡地, 向上地 // adj. 上坡的, 向上的，费力的 // n. 上坡
wane |  n. 衰微, 亏缺, 变弱 // v. 变小, 亏缺, 呈下弦
transfer |  n. 迁移, 移动, 换车 // v. 转移, 调转, 调任
imitate |  v. 模仿 // vt. 仿制,仿造,模仿,仿效
benefit |  n. 利益, 津贴; 义卖, 义演 // vt. 有益于 // vi. 得益
optimistic |  adj. 乐观的, 乐观主义的
prospective |  adj. 未来的, 预期的
dump |  n. 垃圾场,堆放处 // vt. 丢弃,抛售,导出 // vi. 骤降,扔垃圾
wax |  n. 蜡,蜡状物,震怒 // vi. 变大,增大,月亮满 // vt. 用蜡涂
refectory |  n. 餐厅
brass |  n. 黄铜(制品),铜管（乐器） // adj. 黄铜的
convenient |  adj. 方便的
conservation |  n. 保存, 防止流失, 守恒, 保护自然资源
conform |  vt. 使一致,遵守,使顺从 // vi. 一致,符合
budget |  n. 预算 // vt. 编预算,为…做预算 // vi. 节省开支 // adj. 不贵的，廉价的
sponge |  n. 海绵, 海绵状的东西 // v. 用海绵擦拭, 吸收掉, 抹掉
curry |  n. 咖哩粉, 咖哩饭菜 // vt. 用咖哩粉调味, 用马栉梳, 制革
cervical |  adj. 颈（部）的, 子宫颈的
collate |  v. 对照, 校对, 校勘
liver |  n. 肝脏
reliable |  adj. 可靠的,可信的
dredge |  n. 挖泥机, 捞网 // v. 用挖泥机疏浚 // v. 把粉撒在
declare |  vt. &vi. 宣布,声明,申报
currency |  n. 货币; 流通
collaboration |  n. 合作, 通敌
calculate |  vt. 计算,估计,考虑,推测 // vi. 计算,预测,依赖
accumulate |  vt. 积聚,累加,堆积 // vi. 累积
decrepit |  adj. 破旧的, 衰老的
stretch |  n. 伸展,张开 // adj. 可伸缩的 // vt. &vi. 伸展,张开,延伸
damage |  n. (pl.)赔偿金,损坏,毁坏 // vt. 损害,毁坏
chart |  n. 图表 // vt. 制成图表
explosive |  adj. 爆炸(性)的 // n. 炸药
vertical |  adj. 垂直的,顶点的,纵向的 // n. 垂直物, 垂直的位置
conclude |  vt. 使结束, 缔结, 断定, 得出结论 // vi. 结束, 作出决定
coupon |  n. 试样(配给票, 息票, 附单)
aerospace |  n. 宇宙空间，航空航天学,航空航天工业 // adj. 航天的，太空的
alpine |  adj. 高山的, 阿尔卑斯山的
amber |  n. 琥珀色,琥珀 // adj. 琥珀色的,琥珀的
amphibian |  adj. 两栖类的, 水陆两用的 // n. 两栖动物, 水陆两用飞机, 水陆两用车
annuity |  n. 年金, 养老金
arduous |  adj. 费力的, 辛勤的, 险峻的
bloom |  n. 花,钢块,兴旺 // vt. 使...开花 // vi. 开花,变得健康
blossom |  n. 花,开花,全盛期 // vi. 开花,成长
brood |  n. 窝 // v. 孵,沉思
buffalo |  n.水牛（分非洲水牛和亚洲水牛两种）； （南非或北美的）野牛
bugbear |  n. 妖怪，烦恼(或恐惧)的根由 // =bugaboo
camel |  n. 骆驼,浮船箱,浅黄棕色
caterpillar |  n. 毛虫；履带车 // 卡特彼勒(财富500强公司之一, 总部所在地美国, 主要经营工业农业设备)
conscientious |  adj. 审慎正直的,认真的,本着良心的
crocodile |  n. 鳄鱼
deduct |  vt. 扣除，减去；
default |  n. 假设值,默认(值),不履行责任,缺席 // v. 默认,不履行义务,缺席,拖欠 // [计算机] 缺省
deft |  adj. 敏捷熟练的, 灵巧的
designate |  adj. 指定的 // vt. 指定,选派,标明
dispatch |  n. 派遣；急件 // vt. 派遣；分派
disposition |  n. 性情,倾向,安排, 处置, 控制 // [计算机] 配置情况
embryo |  n. 胚胎,萌芽
ephemeral |  adj. 朝生暮死的, 生命短暂的
femur |  n. 大腿骨, 股骨
ferocious |  adj. 残忍的, 凶猛的，极度的，十分强烈的
flora |  n. 植物, 群落 // （大写）Flora：[罗神]花神弗洛拉，弗洛拉（女名）
fragrant |  adj. 芬香的,馥郁的,愉快的
fruition |  n. 结果, 成就, 实现
gigantic |  adj. 巨大的
grassy |  adj. 绿色的 像草的
halibut |  n. 大比目鱼
hassle |  n. 激战,争吵 // vi. 争论 // vt. 与...争辩,不断骚扰
hawk |  n. 鹰,掠夺别人的人,鹰派人物 // n. 清嗓 // v. 用训好的鹰捕猎,像鹰一般地袭击,鹰啸，清嗓 // v. 沿街叫卖
heterogeneous |  adj. 异种的, 异质的, 由不同成份形成的 // [计算机] 非均匀的
highland |  n. 高地, 山地 // Highland: 苏格兰高地
hound |  n. 猎狗, 可鄙之人, 角鲨，追踪者 // vt. 带猎犬狩猎, 不断骚扰
inactive |  adj. 不活动的,停止的,怠惰的 // [化]惰性的 // [物]无旋光的
innocuous |  adj. 无害的, 无毒的，无关痛痒的
innumerable |  adj. 无数的, 数不清的
inshore |  adj. 近海岸的,向陆的 // adv. 近海岸,向陆
instantaneous |  adj. 瞬间的, 即刻的 // adv. 瞬间, 霎时
leafy |  adj. 叶茂盛的, 多叶的, 叶状的
lotus |  n. 荷花(莲花, 莲饰)
luminous |  adj. 发光的, 发亮的，清楚的，明白易懂的
mildew |  n. 霉病, 发霉 // v. (使）发霉, （使）生霉
monstrous |  adj. 畸形的, 怪异的，巨大的
mucous |  adj. 黏液的, 似黏液的 // =mucus
oasis |  n. 绿洲
observatory |  n. 天文台；气象台；瞭望台
paddock |  n. (用来放牧、驯马等的)围场，赛前停车场，一片围地（澳） // vt. 限制在围地里
parakeet |  n. 长尾鹦鹉
peninsula |  n. 半岛
perish |  vt. 毁减,死亡 // vi. 毁灭
perishable |  adj. 易腐烂的, 会枯萎的, 会死的 // （复数）perishables:易腐烂的东西（尤指食物）
planetarium |  n. 天文馆
plankton |  n. 浮游生物
plume |  n. 羽毛 // v. 整理羽毛, 骚首弄姿 // vt. 用羽毛装饰
precipice |  n. 断崖, 绝壁, 险境
prolific |  adj. 多产的, 作品丰富的
proximity |  n. 接近,亲近
shoal |  adj. 浅的 // n. 浅水处，沙洲 // n. 鱼群，一大群 // v. （使)变浅 // vi. 群聚
shrimp |  n. 虾,瘦小的人事物 // vi. 钓虾
sprout |  n. 芽, 萌芽 // v. 使发芽, 长芽
starfish |  n. 海星
swirl |  n. 漩涡, 涡状形 // v. 使成漩涡, 头晕
thyroid |  n. 甲状腺 // adj. 甲状腺的
translucent |  adj. 半透明的
turbot |  n. 比目鱼之类
unicorn |  n. (传说中的)独角兽
wallaby |  n. 小袋鼠,澳洲土人
wither |  vt. 使凋谢，使衰退, (用眼神气势等)使畏缩 // vi. 枯萎,衰退,消亡
yelp |  n. 叫吠,叫喊声 // v. 叫吠,叫喊
zoology |  n. 动物学
locate |  vt. 找出,设于,位于,建立 // vi. 建立
random |  n. 随意,任意 // adj. 任意的,随便的,胡乱的 // adv. 随机地
available |  adj. 可用的,可得到的,有用的，有效的
contempt |  n. 轻视,轻蔑
array |  n. 数组,(陈)排列,大批,一系列 // vt. 排列,布署,打扮
abuse |  n.滥用； 恶习； 侮辱； 恶言 // vt.滥用； 虐待； 辱骂
burgeon |  n. 芽, 嫩枝 // v. 萌芽, 发芽
imitation |  n. 模仿,效法 // adj. 假造的,冒充的
respond |  vi. &vt. 回复,反应，响应，应答 // n. 拱柱
humanity |  n. 人类 人性;人道;慈爱
oppose |  vt. 反对,以...对抗,抗争
welfare |  n. 福利,社会保障,幸福 // adj. 福利的
compatriot |  n. 同国人 // adj. 同国的, 同胞的
primitive |  adj. 原始的 // n. 原始人,文艺复兴前的艺术家
static |  n. 静电, 静电干扰, 噪声, 阻碍, 抨击 // adj. 静态的,静电的,固态的
therapy |  n. 疗法,治疗
discount |  n. 折扣, 贴现率 // vt. 打折扣, 贴现, 不重视，不全信 // vi. 贴现, 减息贷款
flush |  n. 流溢, 面红, 旺盛, 冲水(尤指冲马桶), 突然萌发, (纸牌)同花顺, 清一色 // [计算机] 冲洗 // vi. 脸发红, 冲刷, 旺盛成长 // vt. 用水冲洗, 惊起(一群鸟), 抄...老窝, 使兴奋 // adj. 丰足的,齐平的,满盈的 // adv. 正直地, 羞涩地
professional |  adj. 职业(上)的,专业的 // n. 专业人员
siesta |  n. 午睡, 晌觉
demand |  n. 要求; 需求 // v. 要求, 查问; 需要
delta |  n. (河流的)三角洲
earthworm |  n. 蚯蚓
barge |  n. 驳船 // vi. 猛撞, 冲, 闯
defendant |  n. 被告
identical |  adj. 相同的,同一的
preference |  n. 偏爱,优先,喜爱物
swamp |  n. 沼泽,湿地 // v. 淹没,陷于沼泽
pressure |  n. 压力, 压强, 压迫
unrealistic |  adj. 不切实际的, 不实在的
potential |  adj.潜在的，有可能的； [语法学]可能语气的，表示可能性的； 有能力的 // n.潜力，潜能； [物]电位，势能； 潜能的事物； [语]可能语气
resource |  n. 资源,谋略,消遣
apprentice |  n. 学徒 // v. 使当学徒
architect |  n. 建筑师
aspiration |  n. 渴望；抱负；送气；吸气；吸引术
avalanche |  n. 雪崩
barometer |  n. 气压计, 晴雨表
breeze |  n. 微风,轻而易举的事 // vi. 飘然而行,轻松地得胜或进步
civilian |  adj. 平民的 // n. 罗马法专家,平民
companion |  n. 同伴, 同事, 成对物品之一, (船的)甲板间扶梯(或扶梯的顶篷) // vt. &vi. 陪伴
confluence |  n. 合流, 合流点, 集合
coordinate |  n. 同等的人物; (色调, 图案, 样式等)配套服装 // adj. 同等的, 等位的; (大学)男女分院制的 // v. 协调, 整合; 使一致 // [计算机] 坐标
cyclic |  adj.循环的，周期性的，环形的
directory |  n. 目录,工商名录,指南 // [计算机] 目录 // adj. 给予指导的
drudgery |  n. 苦差事, 苦工
empirical |  adj. 经验主义的
errand |  n. 差使,差事
executive |  n.总经理； 行政部门； [计算机]执行指令 // adj.执行的； 管理的； 政府部门的
fortnight |  n. 两星期，十四天
inapt |  adj. 不适当的, 不合适的
inattention |  n. 不注意, 粗心, 疏忽
incipient |  adj. 起初的,发端的,初期的
incite |  v. 煽动，刺激, 激励
inept |  adj. 不适当的, 无能的, 笨拙的
intermittent |  adj. 间歇的,断断续续的
intractable |  adj. 不听话的, 倔强的, 棘手的
laborious |  adj. 艰苦的, 费劲的
layman |  n. 俗人(对僧侣而言), 门外汉
liable |  adj. 有义务的,应负责的,有...倾向
magistrate |  n. 地方法官，地方行政官
malpractice |  n. 失职, 行为不当
memorandum |  n. 备忘录
mobilize |  v. 动员,赋予可动性, 使流通 // v. 动员
nautical |  adj. 海上的, 航海的, 船员的
naval |  adj. 海军的,军舰的
nominate |  vt. 提名, 指派, 登记赛马参加比赛
novice |  n. 新手,初学者
obligate |  v. 使负义务, 强制, 预留
occupational |  adj. 职业的
overture |  n. 提议, 提案, 初步交涉, 序曲 // v.提议，建议
overwrought |  adj. 过分劳累的，过度兴奋的，过分装饰的
palpitate |  vi. 悸动, 心跳, 发抖
payroll |  n. 工资单,计算报告表,工薪总额
personnel |  n.全体员工； （与复数动词连用）人员，员工； 人事部门
pester |  v. 使烦恼, 使苦恼
piggyback |  adv.&amp;adj. 在肩(背)上,骑在肩(背)上地
ploy |  n. 活动(手法)
posthumous |  adj. 死后的；遗腹的；作者死后出版的
postpone |  v. 延期 // vt. 推迟,延期
practicable |  adj. 可实行的, 可做的, 可用的
prosecute |  vt. 对...提起公诉,彻底进行,追捕,经营,从事 // vi.起诉,担任检察官
reliance |  n. 信赖,所信赖的人或物
reliant |  adj. 依赖的,信赖的,可靠的
resolve |  n. 决定之事,决心,坚决 // vt. 决定,解决,分离,表决 // vi. 分离,决定
restless |  adj. 不安宁的, 焦虑的
seniority |  n. 长辈, 前任者的特权, 老资格
shepherd |  n. 牧羊者, 牧师, 指导者 // v. 看守, 领导, 指导
simplify |  v. 简化, 使单纯 // vt. 简化
steward |  n. 乘务员；干事；理事 // vt.&vi. 做乘务员,管理
superintend |  vt. 指挥, 管理, 监督
synthesize |  v. 合成
teamwork |  n. 合作, 协同工作
trivial |  adj. 琐碎的, 不重要的
underling |  n. 部下,下僚,下属
vacancy |  n. 空白, 空缺
vacation |  n. 假期, 休假，腾出 // vi. 度假
warden |  n. 典狱官, 看守人, 学监
workaholic |  n. 工作第一的人,专心工作的人
formidable |  adj. 强大的, 可怕的, 难对付的
compound |  n. 混合物,复合词 // adj. 复(混)合的,合成的 // vt. 混合,调合,妥协 // vi. 混合,妥协
original |  adj. 最初的, 原始的; 有独创性的, 原版的 // n. 原件, 原稿; 有独创性的人, 怪人
collapse |  n. 崩溃,倒塌,暴跌 // vi. 倒塌,崩溃,瓦解,折叠 // vt. 倒塌,缩减
juvenile |  adj. 年轻的,青少年的,幼稚的 // n. 青少年,青少年读物,幼雏,扮演少年的演员
reject |  n. 被拒之人,不合格品,不及格者 // v. 拒绝,驳回,丢弃
economical |  adj. 节俭的, 经济的, 合算的
homogeneous |  adj. 同种的,同质的,均质的
expansion |  n. 扩大,膨胀,扩充
consideration |  n. 考虑, 体贴, 考虑因素, 敬重, 意见
fibre |  n. 纤维, 纤维组织, 织地
curriculum |  n. 课程，全部课程
branch |  n. 分支,树枝 // vt &vi. 分支, 分岔
material |  n. 材料, 原料, 物质; // n. 素材, 题材, 资料 // adj. 物质的, 实体的; 身体上的, 肉体的 // adj. 重要的, 关键的
mediocre |  adj. 平庸的, 平凡的
shorthand |  n. 速记,缩写
triangle |  n. 三角(形)
extension |  n. 延长,扩充,范围,分机号码
compensate |  vt. &vi. 偿还,补偿,付报酬
deliberate |  adj. 故意的,深思熟虑的, 从容不迫的 // vi. 仔细考虑 // vt. 研讨
spit |  n. 唾液, 唾吐, 小雨 // v. 唾吐, 吐出, 降小雨
approve |  vt. 批准,核准,证实 // vi. 赞同
revolution |  n. 革命, 旋转, 转数
contain |  vt. 包含,容纳,克制,抑制 // vi. 自制
horizon |  n. 地平线；视野；眼界
improve |  vt. 改进,利用,(提高)价值 // vi. 改进
alignment |  n. 队列，成直线；校准；结盟
staff |  n.参谋； 全体职员； 管理人员； 权杖 // adj.行政工作的； 参谋的； 职员的； 作为正式工作人员的 // v.在…工作； 为…配备职员； 任职于
diminish |  vt. 减少,变小, 减损 // vi. 变少, 逐渐变细
aquarium |  n. 水族馆,养鱼池,玻璃缸
blindfold |  adj. 被蒙上眼睛的 // adv. 盲目地 // v. 蒙住眼睛 // vt. 蒙住...的眼睛
boulder |  n. 大圆石，巨砾
cascade |  n. 瀑布，[电]串联 // v. 瀑布似地落下，（将...）连结，串联
cataract |  n. 大瀑布, 奔流, 洪水,[医]白内障
civic |  adj. 公民的, 市民的, 城市的
clamor |  n. 喧闹,叫嚷,大声的要求 // v. 喧嚷,大声的要求
congratulate |  vt. 祝贺
corrode |  v. 使腐蚀,侵蚀,破害 // v. 腐蚀,被侵蚀
crevice |  n. (岩石、墙等)裂缝
deluge |  n. 大洪水, 暴雨，泛滥 // v.泛滥，大量涌入
dissipate |  vt. 使...消散(浪费)
drench |  n. 浸湿，有毒药剂 // vt. 灌药，湿透，过分沉溺
droplet |  n. 小滴，飞沫
drowsy |  adj.昏昏欲睡的 // adj.寂静的
exterior |  n. 外部, 表面, 外型 // adj. 外部的, 外在的, 表面的 // [计算机] 外部的
familiarity |  n. 亲密, 熟悉, 精通，不拘礼节
fetus |  n. 胎, 胎儿
filament |  n. 细丝, 细线, 单纤维
flake |  vi. 剥落；成片状剥落 // vt. 使…成薄片；将…剥落 // n. 小薄片；火花
flux |  n. 流出,流量,涨潮,变迁,助熔剂 // vt. 使熔化,使泻,涨 // vi. 熔化
fume |  n. 臭气, 烟, 激怒 // v. 熏, 冒烟
furnace |  n. 炉子,熔炉,闷热地带,严峻考验
gale |  n. 狂风, 一阵（喧闹，笑声等）
grit |  n. 砂砾, 粗砂石，勇气，决心 // v. 覆以砂砾，咬紧牙关
gust |  n. 突然一阵 // n. 风味 // vi. 猛吹
havoc |  n. 大破坏,混乱 // vt. 破坏
hilarious |  adj.欢闹的； 非常滑稽的； 令人捧腹的； 喜不自禁的
influx |  n. 流入, 河口, 辐辏 // 涌进; 汇集[C][S1] // an influx of customers // 顾客的蜂拥而来
inlet |  n. 水湾，入口 // vt.引进，插入
landward |  adj. 向陆地(近陆地的) // adv. 向陆地(近陆地的)
laundry |  n. 洗衣店, 要洗的衣服, 洗衣
lavatory |  n. 盥洗室, 厕所
lottery |  n. 彩票
meteoric |  adj. 流星的, 昙花一现的，大气的
mire |  n. 泥沼, 泥泞 // v. 使...陷于泥泞, 使...陷入困境
onus |  n. 负担, 义务，耻辱
overrun |  v. 蔓延, 泛滥，侵占，流行，超越 // n.超出量，风行，泛滥，侵占
pamper |  v. 放纵,使吃饱,使过量
paternity |  n. 父系, 父系后裔
pebble |  n. 鹅卵石 // n. 水晶, 水晶透镜 // v. 用卵石铺,用卵石投掷,使有卵石纹
penury |  n. 贫穷，拮据
petroleum |  n. 石油
phenomenal |  adj. 现象的, 可感知的, 非凡的
pinnacle |  n. 小尖塔, 尖峰, 高峰 // vt. 造小尖塔, 放置高处
porous |  adj. 可渗透的, 多孔的
potluck |  n. 便饭 // 每人自带一个菜的家庭聚会
precinct |  n. 选区, 管理区, 管辖区域
quagmire |  n. 沼泽(绝境)
ruinous |  adj. 破坏性的, 招致毁减的, 零落的
saturate |  v. 使渗透, 浸, 使饱和 // adj. 浸透的, 饱度高的, 深颜色的
scant |  adj. 不充分的, 不足的 // v. 减缩, 限制，忽略
scorch |  v. （使）烧焦, 变焦, （使）枯萎 // n. 烧焦
scum |  n. 浮渣,水金秀,槽粕 // v. 将浮渣去除掉,产生浮渣
shave |  n. 修面,刮胡子 // vt. 修面,剃,擦过,消减价格 // vi. 刮胡子,勉强通过
sluice |  n. 水闸(闸沟,斜槽,蓄水,口) // vt 冲洗(流出,开水闸放水,溜槽提金)
slurry |  n. 泥浆
snowbound |  adj. 被雪封住的(被雪围住的,被雪困住的)
sparse |  adj. 稀少的, 稀疏的
sphere |  adj. 球体的 // n. 范围, 领域, 球, 球体
strait |  n. 海峡；（连接两大水域的）水道；（由拮据引起的）困境；窘迫
submerge |  vt. 使浸没, 潜入水中, 覆盖 // vi. 浸没
summit |  n. 顶点;最高阶层 // vi. 参加最高级会议,爬到最高点
surround |  n. 环绕物 // vt. 包围,环绕
sustenance |  n. 维持生计, 食物
temperate |  adj. 温和的, 适度的, 有节制的
thorny |  adj. 多刺的,棘手的,痛苦的
topple |  vt. 使倒塌 // vi. 倒塌
torrent |  n. 激流, 山洪
trickle |  vi. 滴流, 慢慢移动 // n. 细流，徐徐地流
turbulent |  adj.骚乱的，混乱的； 激流的，湍流的； 吵闹的； 强横的
turf |  n. 草皮,泥炭,跑马场 // v. 铺草皮 // n. 地盘,势力范围
twig |  n. 小枝, 嫩枝 // v. 理解，领悟
upholster |  vt. 为（椅子等）装垫子，装潢
voluptuous |  adj. 激起性欲的, 沉溺酒色的，撩人的
vortex |  n. 漩涡, 旋风
wean |  v. 断奶,戒掉 // vt. 给(婴儿)断奶
whirlwind |  n. 旋风 // adj. 旋风般的
rotate |  vt. &vi. (使)旋转,轮流 // adj. 车轮状的
anticipate |  vt. 预期，期望；占先，抢先；提前使用
physician |  n. 内科医生
ventilation |  n. 通风处, 通风设备, 充气
reveal |  vt. 显示, 透露 // n. (外墙与门或窗之间的)窗侧, 门侧 // n. (汽车的)窗框
threshold |  n. 极限,门槛,入口,开端
turnover |  n. 翻覆, 翻折, 半圆卷饼, 营业额, 成交量 // adj. 翻折的领子
aggressive |  adj. 侵略性的；好斗的；有进取心的；有闯劲的
cylinder |  n. 汽缸, 圆筒, 圆柱体
habitat |  n. (动植物的)产地,栖息地
attend |  vt. 参加,注意,照料 // vi. 专心,留意,待命
profound |  adj. 极深的,深奥的,深厚的,严重的
dweller |  n. 居民
absorb |  v. 吸收,吸引...的注意,使全神贯注
log |  n. 记录,圆木,日志,计程仪 // vt. 伐木,切,记录,航行,度过(时间) // vi. 采伐
badge |  n. 徽章,标记
appointment |  n. 约会, 预约, 任命, 委派, 官职, 设备
exhale |  v. 呼气, 发出, 散发
supplement |  n. 补充物,增刊 // vt. 补充,增补
substantial |  n. 重要部份, 本质 // adj. 大量的, 实质上的, 有内容的
nasty |  adj.肮脏的； 下流的，令人讨厌的； 恶劣的，艰险的； 严重的 // n.令人不愉快的事物
implement |  n. 工具, 器具; 当工具的物品 // vt. 实施, 执行; 向...提供工具(或手段)
formulate |  vt. 规划；用公式表示；明确地表达
veterinary |  adj. 兽医的 // n. adj.兽医(的)
cosmopolitan |  adj. 世界性的, 久经世故的
comedy |  n. 喜剧,滑稽, 幽默事件
excreta |  n. 排泄物
preferable |  adj. 更好的, 更合意的
intact |  adj. 尚未被人碰过的,原封不动的,完整的, 完好无缺的
asthma |  n. 哮喘
sequence |  n. 序列, 一系列, 顺序, 一组镜头 // vt. 安排顺序
dialect |  n. 方言
arrogance |  n. 傲慢, 自大
aeronautics |  n. 航空学
antecedent |  n. 前情, 先行词 // adj. 在...之前的, 居先的
auction |  n. 拍卖 // vt. 拍卖
blotter |  n. 吸墨纸, 临时记事簿
cathedral |  n. 大教堂
centennial |  n. 百年纪念 // =centenary(美) // adj. 一百年的
chime |  n. 鸣, 钟, 和协 // v. 鸣, 打, 和协
colonialism |  n. 殖民主义
condolence |  n. 引, 哀悼, 引辞
crockery |  n. 陶器, 瓦器
customary |  adj. 习惯的, 惯例的
debris |  n. 碎片, 残骸
decompression |  n. 还原，解压
decouple |  vt. 分离，拆散
delete |  vt. 删除
downsize |  v. 缩小规模, 通过减员缩小公司规模
eternal |  adj. 永久的,永恒的 // n. 永恒的事
etiquette |  n. 礼仪, 礼节, 成规
exile |  n. 放逐,流放,被放逐者 // vt. 放逐,流放
fallacy |  n. 谬论
flask |  n. 细颈瓶, 烧瓶, 小水瓶
genocide |  n. 种族灭绝
halve |  v. 对分, 减半 // vt. 分成两半, 平分, 减少到一半
holocaust |  n. 大屠杀,浩劫
illuminate |  vt. 照明,阐释,说明
indemnity |  n.赔偿； 保障； 赔偿金
inferential |  adj. 推理的，推论的，推理上的
inflation |  n. 膨胀,通货膨胀
interface |  n. 界面,接触面 // vt. 连接,作接口 // vi. 连接
inventory |  n. 详细目录, 存货(清单) // vt. 编制(详细目录)
microbiology |  n. 微生物学
microcosm |  n. 小宇宙，微观世界，缩影
microscope |  n. 显微镜
modulate |  v. 调整, 调节（声音），变调
multifarious |  adj. 多种的, 各式各样的
necessitate |  v. 迫使, 使...成为必需, 需要
neutralize |  v. 使中立, 使成中立地带, 中和
notional |  adj. 虚的；概念上的(想象的,象征的)
nozzle |  n. 喷嘴
nucleus |  n. 核,核心,细胞核,原子核
observance |  n. 遵守, 仪式, 惯例
odometer |  n. 里程表
oxide |  n. 氧化物
oxidize |  v. 氧化,生锈 // vt.&amp;adv. 使氧化
panel |  n.镶板； 面； （门、墙等上面的）嵌板； 控制板 // vt.选定（陪审团）； 把…分格； 在…上置鞍垫； 把…镶入框架内
persistent |  adj. 固执的,坚持的,连续的
pilgrim |  n. 朝圣者 // Pilgrim: 1620年移居美洲的英国清教徒
polarity |  n. 有两极, 磁性引力, 极性 // n. 两极分化, 极端性
ponder |  vt. &vi. 沉思,考虑
prophecy |  n. 预言, 先兆, 预言能力 // =prophesy
protract |  vt. 延长, 托长, 伸出
regeneration |  n. 再生, 重建
resilient |  adj. 弹回的,有弹力的,愉快的
retention |  n. 保存(保持力,包装牢固,记忆力,保留物)
reverent |  adj. 恭敬的, 虔诚的
ripple |  n. 涟波,涟漪,波纹,粗钢梳 // vt. 使...起涟漪,使起波纹 // vi. 呈波浪状, 起伏前进
sieve |  n. 筛子, 粗篮, 说话轻率不能保密的人 // v. 筛, 滤
solvent |  n. 溶剂,解决者 // adj. 有偿付能力的,有溶解力的
stagnate |  v. 停止，停滞不前，不景气
surmount |  vt. 克服, 越过，登上...最高点
surplus |  adj. 多余的,过剩的 // n. 过剩,剩余物,盈余,顺差
tentative |  n. 试验,假设 // adj. 试验性质的,暂时的,犹豫不决的
tertiary |  adj. 第三的,第三位的,第三世纪的 // n. 臂翼,第三重音,第三会员
unilateral |  adj. 单方面的,单边的,片面的,单系的
validity |  n. 有效性,正确性,正当
venerable |  adj. 庄严的, 值得尊敬的
venerate |  vt. 尊敬, 崇敬, 崇拜
warranty |  n. 担保,保证,根据
derive |  v. 得自, 起源, 引申于
literacy |  n. 读写能力，识字
audacious |  adj. 大胆的,放肆的,无礼的,厚颜无耻的
infrastructure |  n. 下部构造, 下部组织, 基础结构, 基础设施
preserve |  vt.保护； 保持，保存； 腌制食物； 防腐处理 // vi.保鲜； 保持原状； 做蜜饯； 禁猎 // n.蜜饯； 防护用品； 禁猎地； 独占的事物（或范围）
sustain |  vt. 承受, 支持, 经受, 维持
skip |  n. 跳跃,跳读 // vt. &vi. 跳越,蹦跳,略过,跳过
convert |  v. 使转变, 使...改变信仰, 倒置 // n. 皈依者, 改宗者
panic |  n. 恐慌,惊惶 // adj. 惊慌的,没有理由的,恐慌的 // vt. 使...惊慌
enthusiastic |  adj. 热情的, 热心的
magma |  n. 岩浆，糊剂
hostility |  n. 敌意, 敌对状态, 公开战争
replace |  vt. 取代,更换
craft |  n. 工艺, 手艺, 狡诈，航空器, 行会成员 // vt. 手工制作
pollution |  n. 污染, 污染物
shade |  n. 色度,荫凉处,稍微 // vt. &vi. 渐变,遮蔽,微减
trigger |  vt. 引发，引起；触发 // vi. 松开扳柄 // n. 扳机；[电子] 触发器；制滑机
intimate |  adj. 亲密的,私人的,秘密的 // n.  密友 // vt. 透露,暗示
criminal |  adj. 犯罪的, 刑事的, 无耻的 // n. 罪犯
bonus |  n. 红利, 奖金
seminar |  n. (大学的)研究班,研讨会
aggravation |  n. 更恶化, 加厉, 恼怒
theory |  n. 理论,原则,看法,推测
generous |  adj. 慷慨的,宽宏大量的,丰盛的,味浓的
occupation |  n. 职业
migrant |  n. 移居者
seal |  n. 印章, 封条, 海豹 // v. 盖印, 封闭, 猎海豹
squash |  n. 壁球,摺皱不堪,拥挤嘈杂的人群,浓缩果汁,美国南瓜  // vt. 压扁,压制  // vi. 变扁,压榨
tramp |  n. 沉重的脚步声, 流浪者 // v. 脚步沉重地缓缓行走, 踏, 流浪
abort |  v. 流产, 打胎, 堕胎
adrenalin |  n. 肾上腺素
amputate |  v. 切断
apace |  adv. 快速地, 急速地，齐头并进地
appendix |  n. 附录,阑尾
aptitude |  n. 才能,资质
articulate |  adj. 有关节的,发音清晰的 // vt. &vi. 以关节连接,接合,明白地说
aspirin |  n. 阿斯匹林
asylum |  n. 收容所，避难所，庇护, 精神病院
audible |  adj. 听得见的
bacterium |  n. 细菌
barricade |  n.路障，街垒，障碍物，栅栏 // （复数）barricades:有激烈争论的领域或议题 // v.设路障挡住，阻拦，封锁
buckle |  n. 皮带扣 // vt.& vi. 扣住,弯曲,专心做事,屈服 // adj. 带扣的,弯曲的
calcium |  n. 钙
capillary |  n. 毛细管 // adj. 毛状的, 毛细管的
cartilage |  n. 软骨
cellulose |  n. 纤维素
cervix |  n. 颈部,子宫口
cramp |  n. 抽筋, 腹部绞痛, 铁箍 // adj. 狭窄的, 难解的 // v. 使...抽筋, 以铁箍扣紧, 束缚
cripple |  n. 跛者, 残废 // v. 使...跛, 使...成残废, 削弱
curative |  adj. 治病的, 有治病效力的 // n. 医药, 治疗药
dehumidifier |  n. 干燥器，干燥装置，减湿器
dehydration |  n. 脱水
delirium |  n. 精神错乱, 说谵语状态, 热狂
detour |  n. 绕路, 便道 // v. 绕路而行
dysentery |  n. 痢疾
exhilarate |  vt. 使高兴, 使愉快，使振奋
fester |  v. 溃烂, 生脓 // n. 脓疮, 溃烂
fidget |  vt. 使坐立不安 // vi. 坐立不安 // n. 烦躁，烦躁之人
fracture |  n. 破碎,骨折 // vt. 破碎,破裂 // vi. 断裂
ghastly |  adj. 可怕的, 鬼一样的, 惨白的，巨大的 // adv. 可怖地, 惨白地
hatchback |  n. 有仓门式后背的汽车
hypnosis |  n. 催眠状态
incision |  n. 切成开口,切割,雕刻
inclination |  n. 倾向, 意愿, 倾斜度
infirmary |  n. 医务室；医院；养老院
inveterate |  adj. 根深的,成癖的,积习的
iodine |  n. 碘, 碘酒
iris |  n. 虹膜, 鸢尾属植物, 彩虹之女神
languid |  adj. 不活泼的，无精打采的，迟缓的
larynx |  n. 喉
maim |  vt. 使残废, 使不能工作, 使伤残 // n. 伤残，残废
malignant |  adj. 有恶意的,恶性的,有害的 // n. 怀恶意的人,保王党员
mania |  n. 狂躁, 热衷, 狂热
marrow |  n. 骨髓, 精华, 活力 // n. 西葫芦
morbid |  adj. 病态的, 不正常的
neurosis |  n. 神经症, 神经衰弱症
oblivious |  adj. 遗忘的；健忘的；不注意的；不知道的
optics |  n. 光学
optometrist |  n. 验光师, 视力测定者，配镜师
oscillate |  v. 振动, 彷徨, 犹豫 // v. 使振动, 使动摇
panacea |  n. 万灵药，灵丹妙药
pathology |  n. 病理学
peculiarity |  n. 特质, 特性, 怪癖, 古怪
perturb |  v. 扰乱,使混乱,使心慌
phobia |  n. 恐怖病, 恐怖症
physiotherapist |  n. 理疗医师
pimple |  n. 丘疹, 脓疱, 疙瘩
plethora |  n. 过量, 多血症
poliomyelitis |  n. 脊髓灰质炎
predisposition |  n. 倾向，癖性，（易患病的）体质
prostrate |  adj. 拜倒的, 降伏的, 伏地的 // vt. 使拜倒, 使屈服, 俯伏
purge |  n. 整肃,清除,泻药,净化 // vt. 净化,清除,摆脱 // vi. 清除,通便,腹泻,变得清洁
raucous |  adj. 沙声的, 粗声的, 刺耳的
recur |  v. 回到, 重现, 再来
relapse |  n. 复旧, 故态复萌, 再发 // v. 故态复萌, 再陷邪道, 再度堕落
rheumatic |  adj. 风湿症的,患风湿症的,引起风湿症的 // n. 风湿症患者,风湿症
scalpel |  n. 外科手术刀,解剖刀
sclerosis |  n. 硬化(症)
seclude |  vt. 隔离(隔绝)
secretion |  n. 分泌, 分泌物、 // n. 藏匿
septic |  adj. 腐败的 // n. 腐败物
signpost |  n. 招牌柱, 广告柱, 路标 // vt. 指示
soothe |  v. 缓和, 使...安静, 安慰
spasmodic |  adj. 间歇的, 痉挛的，突发性的
sterilize |  vt. 使不育，杀菌，使贫瘠
surcharge |  n. 装载过多, 额外费
toddler |  n. 初学走路的孩子
tonic |  n. 补药,奎宁水,[音]主调音或基音, // adj. 滋补的,振奋精神的,[医]肌肉紧张的,[音]主音的
transfuse |  vt. 移注, 输血，渗入，灌输
tuberculosis |  n. 肺结核
vicinity |  n. 邻近,周边地区
vomit |  vt.& vi. 吐出,呕吐 // n. 呕吐物
wrench |  n. 扳钳,猛扭,痛苦 // vt. 猛扭,扭伤 // vi. 猛扭,扭伤,曲解
appropriate |  adj. 适当的, 相称的 // vt. 拨出(款项); 占用
odour |  n. 气味 // =odor(美)
scatter |  n. 散布, 零星少量 // vt. 驱散, 散播 // vi. 分散, 消散
victim |  n. 受害者,牺牲
heritage |  n. 遗产, 继承物
consortium |  n. 联合,合伙,国际财团
questionnaire |  n. 调查表
civilization |  n. 文明,文化
instinct |  n. 本能, 天性, 直觉
stroke |  n. 中风；冲程；笔画；打击；尝试；轻抚 // vt. 抚摸；敲击；划尾桨；划掉 // vi. 击球；作尾桨手；敲击键盘
manufacturer |  n. 制造商
decibel |  n. 分贝（音量的单位）
glacial |  adj. 冰的, 冰川(期)的
dedicate |  vt. 献出,提献辞,致力于
exhaust |  n. 排气,排气装置 // v. 用尽,耗尽,使...精疲力尽 // [计算机] 排除
legacy |  n. 祖先传下来之物,遗赠物 // adj. [计算机]旧系统的
squeeze |  n. 压榨,榨出的少量,佣金,经济拮据 // vt. 紧握,挤压,使经济困难 // vi. 让步,压迫,险胜
launch |  n.&amp;v. 下水,发射,开始,升天,汽艇
endorse |  vt. 背书；认可；签署；赞同；在背面签名
encase |  v. 包围,装入箱内 // vt. 把...装入箱中,包起
steady |  adj. 稳定的,稳固的,沉稳的 // adv. 平稳地,稳固地 // n. 固定的事物 // vi. &vt. (使)稳固,(使)稳定
dispenser |  n. 药剂师, 配药员, 分配者
nuclear |  adj. 原子核的,原子能的
tendency |  n. 趋势,倾向
fluctuate |  vi. 变动, 上下, 动摇 // vt. 使动摇
diversity |  n. 多样化，（人在种族、民族、宗教等方面的）多样性； 差异； 分歧 // vt. 使不同,使多样化
critic |  n. 批评家, 评论家
counterpart |  n.  职位（或作用）相当的人；对应的事物
secondary |  adj. 中级的,中等的,次要的 // n. 次要位置, 副手
acumen |  n. 锐敏, 聪明
ambivalent |  adj. (对同一人或物)有矛盾看法的,或矛盾感情的, 矛盾心理的，矛盾情绪的
augment |  vt. 增加,补充 // vi.扩大 // n. 增加,补充物
bespectacled |  adj. 带眼镜的
blush |  n. 脸红,外观 // vi. 泛红,羞愧
chaste |  adj. 贞洁的, 纯洁的, 朴素的
clumsy |  adj. 笨拙的, 笨重的, 不得体的
coalition |  n. 结合, 合并, 联合
commercialize |  v. 商业化
cordial |  n. 兴奋剂, 补品 // adj. 热忱的, 诚恳的, 兴奋的
credible |  adj. 可信的, 可靠的
deflate |  v. 放气，抽出空气 //  2. v. 打击，使....失去信心，使某人觉得不再重要
discreet |  adj. 谨慎的
entity |  n. 存在,实体
equilibrium |  n. 平衡,均衡
equitable |  adj. 公平的, 公正的
erratic |  adj.飘忽不定的； 行为古怪，反复无常； （运动或行为）不规则的
explicit |  adj. 明确的,详述的，明晰的,外在的
facade |  n. 建筑物的正面,外表(犹指虚伪的)
fatuous |  adj. 愚昧的, 昏庸的, 发呆的, 愚笨的, 自满的
flabby |  adj. 软弱的, 没气力的, 不稳的
foible |  n. 小缺点, 小毛病 // n. 剑刃
freak |  n. 怪人,怪事,反复无常,狂热爱好者  // adj. 奇异的,不正常的 // vt. 使强烈反应(震惊,畏惧) // vi. 在药物影响下变得异乎寻常
gaunt |  adj. 憔悴的, 荒凉的
genial |  adj. 和蔼的, 亲切的, 宜人的
gullible |  adj. 易受骗的，轻信的
husky |  adj. 声音沙哑的 // adj. 有壳的 // adj. 强壮的 // n. 哈士奇，强壮的人
hysterical |  adj. 歇斯底里的, 异常兴奋的
inexorable |  adj. 不为所动的, 坚决不变的
ingenious |  adj. 机灵的,精制的,有独创性的
ingenuous |  adj. 坦白的, 正直的, 天真的
insolent |  adj. 粗野的, 无礼的
insolvent |  adj. 无力偿还的, 破产的 // n. 无力还偿者, 破产者
invoice |  n. 发票, 发货单, 货物 // vt. 开票, 寄发票, 开清单
judicious |  adj. 头脑精明的,贤明的,判断正确的
ludicrous |  adj. 荒谬的, 可笑的，滑稽的
lukewarm |  adj. 微温的, 不热的
magnanimous |  adj. 度量大的, 宽大的, 有雅量的，高尚的
masculine |  n. 阳性, 男性 // adj. 男性的, 阳性的, 有丈夫气的
mercantile |  adj. 贸易的,商业的 // n. 商品
mercenary |  adj. 唯利是图的，雇佣的 // n. 唯利是图的人，雇佣兵
muscular |  adj. 肌肉的, 肌肉发达的
nostril |  n. 鼻孔
obedient |  adj. 服从的, 顺从的
oblique |  adj. 间接的,斜的，拐弯抹角的，不光明正大的 // n. 倾斜物 // [解]斜肌 // v. 倾斜
obnoxious |  adj. 可憎的, 不愉快的, 讨厌的
obstinate |  adj. 固执的, 倔强的，不易屈服的，（病）难治的
pathetic |  adj. 可怜的，悲哀的；感伤的；乏味的
prosecution |  n. 实行,经营,起诉
pygmy |  n. 矮人, 侏儒
reciprocal |  adj. 相互的,互惠的,互补的 // n. 相互, 互惠 // [数］ 倒数
remittance |  n. 汇款
reshuffle |  vt. 再洗牌, 改组 // n. 改组
reticent |  adj. 无言的, 沉默的, 谨慎的
rhetoric |  n. 修辞, 华丽虚饰的语言, 修辞学
shabby |  adj. 破旧的(低劣的)
sinew |  n. 肌肉, 精力, 原动力 // vt. 赋予力量，支持
slack |  n. 松弛的部分, 松散, 淡季, 中止 // adj. 松弛的, 不流畅的 // vt. 使缓慢, 疏忽 // vi. 变松弛, 逃避工作
stagnant |  adj. 不流动的, 不景气的
stark |  adj. 完全的；荒凉的；刻板的；光秃秃的；朴实的 // adv. 完全；明显地；突出地；质朴地
statistic |  n. 统计数值
statistician |  n. 统计学家, 统计员
sturdy |  adj. 强健的, 健全的
subjective |  adj. 主观的 // n. 主格,主观事物
subliminal |  adj. 下意识的,识阈的,潜在意识的
subside |  vi. 沉没,平息
subsidiary |  adj. 辅助的,附属的 // n. 子公司,附属机构
taxation |  n. 课税, 征税, 税金
temperament |  n. 气质, 性质, 性情
tenacious |  adj. 紧粘不放的, 固执的, 不屈不挠的
urbane |  adj. 温文尔雅的, 懂礼的
valuation |  n. 评价,估价,价值判断
virile |  adj. 男性的, 男的, 有男子气概的, 精力充沛的
arboreal |  adj. 树木的, 栖于树木的
beneficial |  adj. 有益的,有利的
treadmill |  n. 踏车, 单调乏味的工作，跑步机
abolish |  vt. 废止,革除
productivity |  n. 生产率, 生产能力
relevant |  adj. 相关的, 切题的, 中肯的
joint |  adj. 联合的, 共同的 // n. 关节, 接合处 // v. 连接, 贴合
adaptation |  n. 改编,适应,改编成的作品
irrigation |  n. 灌溉
advent |  n. 出现,到来
dispose |  vt. 倾向于,处置 // vi. 销毁
dispose of |  vt. 处理(安排,解决)
appreciate |  vt. 欣赏,感激,赏识 // vt. 领会，充分意识 // vi. 增值
assert |  vt. 主张,声明,断言
boost |  n. 推进,支援,增加 // vt. 推进,提高
bother |  vt. 烦扰 // vi. 烦扰,操心 // n. 烦扰
broaden |  v. 变宽, 伸广
cherish |  vt. 珍爱,抚育,珍藏
commit |  v. 委托(托付), 犯罪, 作...事, 承诺 // [计算机] 委托
complement |  n. 补语；余角；补足物；补体 // vt. 补足，补助
condemn |  vt. 判刑, 谴责, 官方宣称（某事物）有缺陷或不宜使用
consume |  vt.  消耗，毁灭，吃，喝, 挥霍 // vi. 耗尽生命, 被烧毁
defy |  vt. 反抗,藐视,挑衅
deny |  vt. 否认, 拒绝, 反对, 克制
fulfill |  vt. 履行,完成
prohibit |  v. 禁止,阻止 // vt. 禁止
pursue |  v. 追捕, 追求, 继续从事
reduce |  vt.换算； 约束； 使变为； 使变弱 // vi.减少； 减轻体重； [生物学]（细胞）减数分裂； （液体）浓缩变稠
undermine |  vt. 暗中损害, 逐渐削弱, 在(某物)下挖洞或挖通道, 从根基处损害
violate |  vt. 违犯, 亵渎, 干扰, 侵犯, 强奸
abundance |  n. 丰富,充裕
abstraction |  n. 抽象, 抽象概念, 心不在焉
amplify |  v. 扩大, 详述, 使...增幅
anthem |  n. 圣歌, 赞美诗
anthology |  n. 诗选, 文选
aphorism |  n. 格言, 警语
asymmetric |  adj. 不对称的
campfire |  n. 营火, 篝火
caption |  n. 说明文字 // v.  给（图片、照片等）加说明文字
catalogue |  n. 目录,总目,系列 // vt. 编制目录,编入目录 // vi. 编制目录,在目录里列出价格
cemetery |  n. 公墓,墓地
centenary |  n. 一百年 // adj. 一百年的
chord |  n. 弦, 和音, 情绪
chronological |  adj. 按时间顺序的
colloquial |  adj. 白话的,口语的,语体的
consecutive |  adj. 连续的,连贯的
depredation |  n. 掠夺, 破坏、蹂躏
dynamite |  n. 炸药，引起轰动的人（或物） // vt. （用）炸药（爆破），炸毁 // adj. 顶呱呱的，极好的
entrenched |  adj. (权力, 风俗等)确立的, 确定的
exponent |  n. 拥护者，说明者，楷模 // n. 指数 // adj. 说明的
furor |  n. 激怒, 狂热, (诗情的)激情
gaudy |  adj. 俗丽的 // n. （英）盛大宴会（尤指大学年会）
generalize |  v. 使一般化, 概括，归纳
Herculean |  adj. 力大无比的，极费力的 // Herculean // adj. [希神]赫拉克勒斯的
hubbub |  n. 嘈杂, 喧哗
humdrum |  adj. 单调的, 乏味的 // n.乏味的谈话
idyll |  n. 田园生活, 田园诗 // =idyl
immortality |  n. 不朽, 永生
impromptu |  adj. 即席的, 即兴的 // adv. 即兴的(地), 无准备的(地)
improvise |  v. 即席写作,即席即兴,即席而作
incinerator |  n. 焚烧装置,焚烧炉,焚尸炉
indelible |  adj. 不能擦除的, 不能磨灭的, 难忘的
indigenous |  adj. 该土地所固有的,土著的,国产的
infernal |  adj. 地狱的(恶魔似的,极度的)
liaison |  n. 联络
literal |  adj. 逐字的, 字面上的, 文字的 // [计算机] 文字的
mannerism |  n. 特殊习惯；矫揉造作；怪癖
martyr |  n. 烈士,殉道者 // vt. 杀害,折磨,牺牲
masculinity |  n. 男性；男子气；刚毅
matrimony |  n. 结婚,婚姻生活,婚礼
melodious |  adj. 旋律美妙的, 调子优美的, 音乐性的
microfilm |  n. 缩影胶片
mythical |  adj. 神话的，虚构的，杜撰出来的
null |  adj. 无效力的,无效的,无价值的 // n. 零 // [计算机] 空 // vt. 使无效
oriental |  adj. 东方(人)的,贵重的
outcast |  adj. 被逐出的,被遗弃的,无家可归的 // n. 被驱逐的人,流浪人,无赖
patriotism |  n. 爱国心,爱国精神
persecute |  vt. 迫害
platitude |  n. 陈词滥调，陈腐
propaganda |  n. 宣传, 宣传的内容
redeem |  vt. 赎回, 挽回, 履行
rehearse |  vt. 预演, 排演, 预先演习 // vi. 参加彩排
ritual |  n. 仪式,典礼,宗教仪式,固定程序 // adj. 仪式的,依仪式而行的，老规矩的，惯常的
sarcasm |  n. 挖苦, 讽刺
solidarity |  n. 团结
sphinx |  n. 狮身人面像, 谜一样的人
trophy |  n. 奖品, 战利品
visualize |  v. 使...看得见,将事物在心里想像,形象
dilemma |  n. 困境,进退两难
genius |  n. 天才, 高智力, 天赋
nutrition |  n. 营养
perspective |  n. 远景, 看法, 透视 // adj. 透视的
superiority |  n. 优越性, 优势
astonish |  v. 使...惊讶
compel |  v. 强迫,迫使
environmental |  adj. 环境的
exaggerate |  vt. &vi. 夸大,夸张
obscure |  adj. 微暗的,难解的,不著名的,[语音学]轻音的  // vt. 使...阴暗,隐藏,使...含糊,成为含糊的元音   // n. 暗淡,模糊
redundant |  adj. 多余的,失业的
jeopardize |  vt. 危害,使受危困,使陷危地
fertilizer |  n. 肥料
catastrophe |  n. 大灾难,大祸,彻底失败
diffuse |  vt. 散播,使(气体或液体)慢慢混合 // vi. 弥漫,扩散 // adj. 冗长的,四散的,散漫的
overtake |  v. 赶上, 突然来袭, 压倒
transition |  n. 过渡,转变
aggravate |  vt. 使...恶化,使...更严重 // vt. [口]激怒
sensational |  adj. 使人感动的, 非常好的, 轰动的, 耸人听闻的
agitation |  n. 激动,兴奋,煽动
alliterate |  v. （使）押头韵
amalgamate |  v. 合并,混合 // vt. 混合
apparatus |  n. 装置, 器具, 机构, 组织
arable |  adj. 可耕的, 适合种植的
bitumen |  n. 沥青
brewery |  n. 啤酒厂
bronze |  adj. 青铜色的 // n. 青铜, 青铜色, 青铜制品, 铜牌(第三名) // vt. 使成青铜色
canal |  n. 运河,沟渠,气管,食管 // vt. 建运河,疏导
caravan |  n. （穿越沙漠的）旅行队, 商队，大篷车
carpentry |  n. 木工手艺,木工业
ceramic |  adj. 陶器的 // n. 陶器, 陶瓷学
chisel |  n.凿子，錾子； <俚>诈骗 // vt.& vi.凿，雕； 錾，镌； 欺骗； 钻进
circumnavigate |  vt. 环航，绕行
consign |  v. 交付, 分配, 委托
contingency |  n. 偶然, 可能性, 意外事故, 可能发生的附带事件
decompose |  vi. &vt. 分解 // vt. 腐烂
fathom |  n. 测量深度, 看穿, 了解，英寻（=6英尺) // vi. 测量深度 // vt. 彻底了解，测深
fermentation |  n. 发酵，骚动
furious |  adj. 狂怒的, 猛烈的
furrow |  n. 犁沟, 皱纹 // v. 犁，耕，（使）起皱纹
granule |  n. 小粒, 微粒
gypsum |  n. 石膏(灰泥板) // vt 用石膏处理
herdsman |  n. 牧民
hitchhike |  v. 搭便车
indignant |  adj. 愤慨的, 愤愤不平的
locomotive |  n. 火车头, 机关车 // adj. 运转的, 火车头的, 移动的
lubricate |  v. 润滑, 加润滑剂
mackintosh |  n. 橡皮布, 橡皮布防水衣, 雨衣
manhole |  n. (位于街面，盖有金属盖，供工人检修、疏浚下水道时出入的)出入孔，检修孔，人孔
memento |  n. 纪念品
methodical |  adj. 有方法的,有系统的
mosaic |  adj. 摩西的 n. 马赛克, 镶嵌细工, 镶木细工
navigable |  adj. 可航行的,可通船的,适于航行的 // adj. 容易环绕的.
nostalgia |  n. 乡愁, 向往过去, 怀旧之情
notch |  n. 刻痕,等级,峡谷 // vt. 刻凹痕,用刻痕计算,计分
odyssey |  n.远行，长途冒险旅行 // n.奥德赛(希腊史诗)
pacify |  vt. 使...平静, 安慰
paraphernalia |  n. [律]已婚妇女的私人财产，随身用品，装备
parody |  n. 打油诗文, 诙谐的改编诗文, 拙劣的模仿 // v. 拙劣模仿, 作模仿诗文
percussion |  n. 打击乐器，撞击，碰撞, 振动,引爆 [医]叩诊
profane |  adj. 亵渎的，不敬神的，世俗的 // vt. 亵渎, 玷污
prosaic |  adj. 散文的，单调的, 无趣的
pseudonym |  n. 匿名, 假名, 笔名
pulley |  n. 滑车, 滑轮，皮带轮
pyre |  n. 火葬柴堆
pyrite |  n. 黄铁矿
quirk |  n. 怪癖,急转
ramble |  v. 漫步, 漫谈, 漫游 // n. 漫步, 闲谈，蔓延
resonant |  adj. 共鸣的, 反响的
saddle |  n. 鞍,车座,山脊,拖具 // vt. 装以马鞍,使负担 // vi. 装马鞍
sectional |  adj. 各部分组成的, 各阶层或不同部分的
shovel |  n. 铲, 挖斗机, 一铲的量 // vt. 铲, 挖, 舀 // vi. 用铲子
spectacle |  n. 值得看的东西, 光景, 眼镜
substantiate |  v. 实体化, 证实
subtitle |  n. 副题(书本中的), 说明或对白的字幕 // vt. 给...加副标题，给...加字幕
symphony |  n. 交响乐
trek |  vt. 艰苦跋涉(行军) // n. 艰苦跋涉
trumpet |  n. 喇叭,喇叭声,喇叭手 // vt. 宣扬；鼓吹；吹嘘 // vi. 吹喇叭,发出喇叭似的声音
wastage |  n. 消瘦, 衰老
waterfront |  n. 水边地, 滨水区 // adj. 滨水区的
yacht |  n. 游艇,快艇 // vi. 驾快艇
supplementary |  adj. 补充的, 附加的
tranquil |  adj. 安静的,宁静的,稳定的,不变的
ultimate |  n. 终极,根本，精华 // adj. 终极的,根本的,极限的,最后的
celebrity |  n. 名人, 著名,著名人士, 名声, 名誉, 社会名流
disposal |  n. 处理,消除,销毁,处置 // n. 弃菜碾碎器
gratitude |  n. 感谢的心情
intake |  n. 引入口, 入口, 通风口
obstacle |  n. 障碍,绊脚石
proponent |  n. 建议者,支持者
pursuit |  n. 追求, 追赶, 工作
statistics |  n. 统计；统计学；[统计] 统计资料
stereotype |  n. 铅版,陈腔滥调,老一套 // vt. 使用铅版,套用老套
triumph |  n. 凯旋,欢欣 // vi. 得胜,成功,庆功
upgrade |  vt. 提高(上升,浓集,加强) // n. 提高(上升,浓集,加强)
worship |  n. 崇拜, 爱慕, 做礼拜 // vi. 做礼拜 // vt. 崇拜, 爱慕
addict |  vt. 使...耽溺,使...上瘾 // n. 耽溺者,上瘾者
advisable |  adj. 明智的,可取的
awkward |  adj. 笨拙的 // adj. 尴尬的
benign |  adj. 仁慈的,温和的,良性的
considerate |  adj. 考虑周到的,体谅的
defiant |  adj. 挑衅的, 目中无人
delinquent |  n. 行为不良的人, 流氓 // adj. 怠忽的, 有过失的
dependent |  adj. 附属的,依赖的,悬垂的 // n. 受经济援助者
disposable |  adj. 用完即可丢弃的
endangered |  adj. （生命等）有危险的,有灭绝危险的,将要绝种的
hospitable |  adj. 好客的，殷勤的，易于接受的，宜人的
indispensable |  adj. 不可缺少的
ammunition |  n. 军火,弹药1) //  弹药  // (2) //  军火, 军需品  // (3) //  [喻]攻击[防御]手段  // (4) //  投掷[射击]物
annihilate |  v. 消灭，歼灭，彻底消除，使无效，废止
apologetic |  adj. 道歉的, 认错的, 赔罪的 // n. 辩护
appraise |  vt. 评价,估价,鉴定
baffle |  v. 困惑, 为难
boycott |  vt. 抵制（贸易），拒绝参加
capitulate |  vi. 有条件投降
census |  n. 户口普查 // v. 实施统计调查
concede |  vt. 承认,给予 // vi. 让步
consciousness |  n. 意识,知觉,自觉,觉悟
console |  vt. 安慰,慰藉 // n. 仪表盘,操控台,(游戏)平台
consolidation |  n. 巩固,团结,合并
contradict |  vt. 反驳,与...矛盾
cynic |  n. 愤世嫉俗者，犬儒主义者，好挖苦的人
desperate |  adj. 不顾一切的,绝望的, 极想得到的
dismay |  n. 沮丧, 绝望 // vt. 使...灰心,使...惊愕
entreat |  vt. 恳求, 乞求
exasperate |  v. 使...恼怒, 激怒, 恶化
exhilaration |  n. 高兴, 兴奋
exhort |  v. 劝诫, 忠告
extol |  vt. 颂扬, 称赞
flatter |  vt.& vi. 阿谀奉承, 取悦, 炫耀 // n. 平整工具
flaunt |  v. 挥动, 夸耀, （厚颜无耻地）炫耀, 飘扬，张扬
grieve |  v. 使...悲伤
grumble |  v. 发牢骚,抱怨，轰鸣 // n. 怨言,牢骚，轰隆声
humiliate |  v. 使...丢脸,使...蒙羞,屈辱
imminent |  adj. 逼近的, 即将发生的
inference |  n. 推理,推论
influence |  vt. 影响, 感化 // n. 影响力, 势力; 影响, 权势 // n. 有影响的人(或事物)
irrevocable |  adj. 不能唤回的, 不能取消的, 不能变更的
lament |  n. 悲叹, 悔恨, 恸哭 // v. 哀悼, 悔恨, 悲叹
laudable |  adj. 值得称赞的
madden |  v. 使发狂, 激怒, 发怒
meticulous |  adj. 一丝不苟的, 精确的
misery |  n. 痛苦,悲惨的境遇,苦难
mutter |  n. 喃喃低语 // v. 喃喃自语, 作低沉声, 出怨言
ominous |  adj. 预兆的,不祥的
ovation |  n. 热烈欢迎, 大喝采, 大受欢迎
perceptible |  adj. 可察觉的, 能感觉得到的, 看得见的
perplexity |  n. 困惑, 混乱
plaintive |  adj. 悲哀的,哀伤的
pompous |  adj. 傲慢的, 自大的, 浮华的
propriety |  n. 适当，正当，得体 // (复数）proprieties:礼节，礼仪
seductive |  adj. 诱惑的, 引人注意的, 有魅力的
sentiment |  n. 感情, 情趣, 意见，观点, 多愁善感
serpent |  n. 蛇, 蛇一般的人, 狡猾的人
significant |  adj. 有意义的, 意味深长的; 相当数量的; 重要的, 重大的 // n. (复)有意义的事物; 标志
solicit |  vt. 勾引, 乞求, 设法获得某事物 // vi. (妓女)拉客
solitary |  adj. 孤独的,独立的,荒凉的 // n. 隐士,
tolerable |  adj. 可容忍的, // adj. 还不错的
touchy |  adj. 易怒的, 难以取悦的, 过敏的
traction |  n. 拖，拽，牵引,牵引力，附着磨擦力
transmute |  v. 使...变形，经历变化
wiggle |  v.扭动，摆动，踌躇 // n.扭动，蠕动，踌躇 // n.奶油青豆烧鱼
irrational |  n. 无理数 // adj. 无理性的, 不合理的
irreversible |  adj. 不可逆转的
legitimate |  adj. 合法的, 正当的, 合理的, 世袭的 // vt. 使合法, 授权, 宣布...为合法
multilateral |  adj. 多边的, 多国参加的
negligent |  adj. 疏忽的, 粗心的, 不在意的
optional |  adj. 可以任选的,非强制的
preliminary |  n. 初步行动, 准备, 初步措施 // adj. 初步的, 开始的, 预备的
rampant |  adj. 猖獗的, 蔓延的, 奔放的
utilize |  vt. 利用
intrinsic |  adj. 固有的, 内在的
workmanship |  n. 手艺, 技巧
degenerate |  adj. 堕落的 // v. 退化, 堕落 // [计算机] 退化
harmonious |  adj. 和睦的, 和谐的, 音调优美的
slacken |  v. 使松弛，使缓慢，变弱
ulterior |  adj. 在那一边的(以后的,进一步的,隐蔽的)
alienate |  v. 使...疏远,离间,让与
differentiate |  vt. 识别, 使差异, 求导数, 区分, 区别对待 // vi. 区别,变异
disoriented |  adj. 分不清方向或目标的, 无判断力的 // 动词disorient的过去式和过去分词形式
hardship |  n. 艰难, 困苦
inferior |  adj. 次等的, 较低的, 不如的
refrain |  n. 重复, 叠句, 副歌 // v. 节制, 避免, 克制
segregate |  adj. 分离的, 被隔离的 // v. 分离, 隔离, 分凝
withdrawn |  adj. 偏僻的，离群的，孤独的 // withdraw的过去分词
endanger |  vt. 危及，危害
inflict |  vt. 施以,加害,使遭受, 折磨
enact |  vt. 制定法律,扮演
adjudicate |  vt. 判决，裁定 // vi. 充当裁判
arbitrate |  v. 仲裁
banish |  vt. 驱逐，流放，消除
chapel |  n. 小礼拜堂, 礼拜仪式，私人祈祷处，唱诗班，印刷厂工会，殡仪馆
coerce |  vt. 强制，迫使，威胁
commotion |  n. 骚动, 暴乱，喧闹
conspiracy |  n. 阴谋
constable |  n. 治安官, 警官, 巡官
constabulary |  adj. 警察的,警官的 // n. 警官队,警察
corpus |  n. [计] 语料库；文集；本金
counterbalance |  n. 平衡,平衡力 // v. 抵销 // vt. 使平衡,抵销
counterfeit |  n. 赝品, 伪造品 // adj. 假冒的, 假装的 // v. 仿造, 伪装, 假装
criterion |  n. 标准, 准则
cuff |  n. 袖口，护腕，裤子翻边; <俚>手铐; 护腕 // vt. 给…上袖口（或翻边）; 用手铐铐; 击掌; 轻拍
deadlock |  n. 僵局, 停顿，(比赛等的)分数不分上下 // v. 停顿, 相持不下
decapitate |  v. 斩首,杀头,开革
decentralize |  v. （使）权利下放, （使）人口疏散
decree |  n. 法令,判决,天意 // vt. 通过法令颁布,裁定
defiance |  n. 蔑视，挑战，挑衅
delude |  vt. 欺骗，迷惑, 蛊惑
derelict |  adj. 被抛弃了的,无主的,玩忽职守的 // n. 遗弃物,被遗弃的人,玩忽职守者
deviate |  vt. 使偏离, 脱离 // vi. 违背,偏离 // n. 叛离者,偏差, 不正常的人或物 // adj. 离经叛道的
dilate |  vt. 使扩大,使膨胀 // vi. 扩大，膨胀，详述
disarray |  v. 弄乱,使混乱,使脱去衣服 // n. 无秩序,杂乱,不整齐的衣服
dispel |  v. 驱散, 驱逐
epitomize |  vt. 摘要；概括；成为……的典范；作为……的缩影
exterminate |  vt. 扑灭, 消灭, 根绝
extort |  vt. 勒索, 敲诈, 强要
falsify |  vt. 伪造, 歪曲, 说谎
feminism |  n. 男女平等主义,女权运动
filth |  n. 污秽(肮脏的)
forensic |  adj. 法院的, 关于法庭的, 适合于辩论的
forfeit |  n. 没收物,罚金,丧失 // vt. 没收,丧失 // adj. 丧失了的
gamble |  n. 冒险 // v. 赌博, 孤注一掷
illogical |  adj. 不合逻辑的, 不合理的
implication |  n. 暗示,含意
implicit |  adj. 暗示的,盲从的 // [计算机] 隐式
inmate |  n. 同住者, 同室者(特指在医院、监狱), 居民
intermediate |  adj. 中级的,中间的 // n. 中间体,媒介物, 调解人 // vi. 调解, 干涉
interrogate |  v. 质问, 讯问, 审问
lull | n. n. 平静时期,间歇
marvelous |  adj. 令人惊异的,了不起的,不平常的
meddle |  vi. 干预，干涉，插手
mediate |  adj. 居间的,间接的 // vt.& vi. 斡旋,调停
misconceive |  v. 误解
molest |  vt. 骚扰, 干扰, 调戏
mystify |  v. 神秘化,使难解,迷惑
notary |  n. 公证人, 公证员
nullify |  v. 使无效, 废弃, 取消
occasional |  adj. 偶然的, 不时的
ordeal |  n. 严酷的考验，痛苦的经验，神裁法
ostensible |  adj. 表面的, 假装的
ostentation |  n.  卖弄，夸耀，摆阔，讲排场
penetrate |  vt. &vi. 穿透,渗透,看穿
postmortem |  adj. 死后的，事后的 // n. 尸体检查, 验尸
precaution |  n. 预防,留心,警戒
quench |  v. 熄减, 结束, 冷浸, 解渴
recede |  vi. 后退,减弱 // vt. 撤回
reckless |  adj. 不计后果的,大意的,鲁莽的
salvage |  n. 救捞(抢修,废物利用,废弃品,救难费) // vt 救捞(抢修,废物利用)
scapegoat |  n. 替罪的羔羊, 替人顶罪者 // v. 使…成为替罪羊
scrutiny |  n. 详细审查；监视；细看；选票复查
simultaneous |  adj. 同时发生的,同步的
squeal |  n. 长而尖的叫声 vi. 发出长声尖叫; 告密，告发
stigma |  n. 耻辱, 污名 // n. 柱头
stint |  v. 节省, 限制, 停止 // n. 舍不得花, 节约, 限制 // n. 连续不断的一段时间从事某件事
successive |  adj. 接连的, 连续的, 接二连三的
succinct |  adj. 简洁的 // adj. [古]紧身的
summon |  vt. 召唤,召集,振奋
tumult |  n. 骚动, 吵闹，喧哗
turmoil |  n. 骚动, 混乱
ultimatum |  n. 最后通牒
whence |  adv. 出于什么原因(从哪里) // pron. 那里(何处)
enlist |  v. 徵募, 参与, 支持
impinge |  v. 冲击,撞击 // vi. 侵犯
infringe |  v. 破坏, 犯, 违反
invade |  vt. 侵略,侵害,拥入
legislative |  n. 立法机构, 立法权 // adj. 立法的, 有立法权的
outlaw |  n. 被剥夺法律保护的人, 罪犯 // v. 使...失去法律保护, 将...逐出社会, 宣告非法
penalize |  v. 处刑, 宣告有罪, 处罚，使不利
suppress |  vt. 镇压,使...止住,禁止
voluntary |  adj. 自愿的, 志愿的 // n. (教堂礼拜仪式前后或进行期间的)乐器独奏
begrudge |  vt. 嫉妒, 羡慕, 对（某人所享有的）感到不满；舍不得给
bleak |  adj. 萧瑟的,严寒的,阴郁的
expertise |  n. 专家的意见,专门技术
momentum |  n. 动力,要素, 势头,（物理）动量
prosper |  v. 兴隆,成功,使...昌盛
self-esteem |  n. 自尊, 自负, 自大, 自尊心
diabetes |  n. 糖尿病
nutrient |  adj. 营养的,滋养的 // n. 营养物,营养品
overweight |  adj. 超重的，过胖的 // n. 超重 // vt.使超重，过于重视
devastate |  vt. 毁坏,使震惊
characteristic |  adj. 特有的, 典型的 // n. 特性, 特征, 特色
innate |  adj. 天生的,固有的
variation |  n. 变化,变动,变种,变奏曲
abbreviate |  vt. 缩写，缩短，使...简略
acquaint |  vt. 使...熟知
adverbial |  adj. 副词的
allude |  vi. 暗示,暗指
analytical |  adj. 分析的,解析的,善于解析的
antonym |  n. 反义词
asterisk |  n. 星号(*)
biometrics |  n.生物测定学
brainstorm |  v. 集体自由讨论 // vi. 动脑筋,出主意,想办法,献计献策 // vt. 集思广益以寻找(解决难题的方法等)
canteen |  n.小卖部； 食堂，小饭馆； 水罐； 餐具盒，炊具箱
centigrade |  adj. 分为百度的,摄氏的
commencement |  n. 开始,毕业典礼
compendium |  n. 简要, 概略，提纲
contention |  n. 争论, 争辩, 所持的论点 // [计算机] 线路争夺
decimal |  adj. 十进位的,小数的 // n. 小数
distil |  v. 蒸馏, 提取....的精华 // =distill
dogma |  n. 教条，信条
elicit |  vt. 引出,诱探出
eloquent |  adj. 雄辩的, 有口才的, 动人的
entrant |  n. (参加比赛的)竞赛者, 新就业者, 新成员
expulsion |  n. 驱逐, 开除,排气
glossary |  n. 字典,辞典 // [计算机] 词汇表
implant |  v. 深植,灌输,嵌入,移植 // n. 移植物,植入物
invigilate |  v. 监考，监督
lucid |  adj. 明白易懂的, 清晰的, 神智清醒的
malice |  n. 恶意, 怨恨，蓄意 // [律]预谋
manacle |  n. 手铐(束缚) // vt 上手铐(束缚)
marginal |  adj. 边际的,末端的,仅以微弱多数获胜的,微小的
massacre |  n. 大屠杀 // v. 大屠杀
meteorology |  n. 气象学, 气象状态
metric |  adj. 公制的,米制的,十进制的 // n. 度量标准,公制,米制,十进制
nitrate |  n. 硝酸盐
numerate |  vt. 数，点，列举 // adj. 数学基础好的
octagon |  n. 八边形, 八角形, 八角堂
partition |  n. 分割,隔离物,隔墙 // v. 区分,隔开,分割
perpendicular |  n. 垂直线,垂直的位置 // adj. 垂直的,直立的
perverse |  adj. 乖张的, 倔强的, 错误的，不正当的，误入歧途的，有悖常理的
piecemeal |  adv. 一件一件,一片一片 // adj. 一片一片的,逐渐的 // n. 断片
pivot |  n. 枢,核心,旋转 // adj. 在枢轴上转动的,关键的 // vt. 装枢轴于,以...为中心旋转 // vi. 在枢轴上转动
plunder |  v. 掠夺, 抢劫, 抢夺 // n. 抢夺, 掠夺品, 战利品
preparatory |  adj. 预备的,准备的,初步的
ransom |  n. 赎金, 赎身, 赎回
rectangle |  n. 长方形,矩形
reiterate |  vt. 反覆地说,反覆地做
resultant |  adj. 作为结果的，合成的 // n. 结果, 产物，[数学] 合矢量，结式
retrial |  n. 再审,覆试
sabotage |  n. 怠工,破坏活动,破坏 // vt. 从事破坏活动,妨害,破坏
semblance |  n. 类似(外观,假装)
singular |  adj. 个人的,单数的,独一的,唯一的,非凡的 // n. 单数
strenuous |  adj. 紧张的；费力的；奋发的；艰苦的；热烈的
subdue |  v. 使服从, 压制, 减弱
synopsis |  n. 摘要,概要
tenable |  adj. 站得住脚的, 无懈可击的
tetrad |  四位组
thermostat |  n. 恒温器
transgress |  vt. 越过(违反,越界,违法)
treble |  adj. 三倍的，最高音部的 // v. （使）成三倍 // n.  三倍，最高音部
triple |  n. 三倍之数,三个一组 // adj. 三倍的
undulate |  adj. 波动的, 起伏的 // v. (使) 波动, (使) 起伏, (使) 震动
variable |  adj. 可变的,易变的 // n. 变量, 易变的东西
variant |  n. 变体 // adj. 不同的
vehement |  adj. 激烈的, 猛烈的
verdict |  n. 裁定, 定论
vigilant |  adj. 警醒的, 警戒著的, 警惕的
zoological |  adj. 动物(学)的
automatic |  n. 自动装置, 半自动武器 // adj. 自动的,机械的,半自动化的
adept |  adj. 熟练的, 老练的 // n. 名手, 专家
be adept at |  v. 擅长
endow |  vt. 捐助,赋予,使具有某种品质
cognition |  n. 认识, 认识力, 知觉
browse |  vt. &vi. 浏览, 随意观看, 吃草 // n. 浏览, 嫩叶
converse |  n. 相反的事物,倒,逆向 // adj. 相反的,逆向的,倒 的 // v. 交谈,谈话 // [计算机] 转换
stimulus |  n. 刺激, 激励, 刺激品
purchase |  n. 购买, 购买的物品 // n. 支点; 紧握, 抓紧 // vt. 购买, 赢得; (用设备)举起, 移动
portrayal |  n. 描绘，肖像，画像
summarize |  vt. &vi. 概述,摘要而言
coherent |  adj. 互相耦合的,清晰的，明了的，凝聚性的,连贯的
apportion |  v. 分配, 分摊, 分派
distribute |  vt. &vi. 分配,散布
outlook |  n. 观点,见解,展望,前景
resistance |  n. 抵抗力,反抗,反抗行动;阻力,电阻;反对 // adj.  抵抗的
elect |  n. 当选人, 被选的人, 上帝的选民 // adj. 被选的, 选出的 // v. 选举, 选择
by correspondence |  用写信的办法
specialist |  n. 专家
gadget |  n. 小机件
provision |  n. 规定, 条款; 供应(品); 预备 // n. (pl.) 食物 // vt. 向...供应食物
tutorial |  n. 个别指导 // adj. 个别指导的
concentrate on |  集中于，专心于
replicate |  vt. &vi. 折叠,复制,模写 // n. 同样的样品 // adj. 转折的
allegiance |  n. 忠诚
antagonism |  n. 对抗，对立，敌对状态（行为）
arbitrary |  adj. 任意的, 专制的, 武断的, 霸道的
basement |  n. 根基，地下室 // n.（新英格兰）特别指学校中的公厕
bungalow |  n. (有凉台的)平房, 小屋
carousel |  n. 旋转木马, （机场的）行李传送带 // =carrousel
confidential |  adj. 机密的,获他人信赖的,易于信任他人的
consonant |  n. 辅音 // adj. 一致的,调和的,辅音的
convene |  v. 集合, 召集, 召唤 // v. 聚集, 集合
custodian |  n. 管理人,保管人,监督人
declaration |  n. 宣布, 宣言
deliberation |  n. 熟虑, 审议
demography |  n. 人口统计学
deploy |  vt. &vi. 展开,配置,部署
deputy |  adj. 代理的, 副的 // n. 代表, 副手
discrete |  adj. 不连续的 离散的 // [计算机] 分离 离散
disintegrate |  v. (使)粉碎,(使)碎裂,解体,瓦解 // vt. 瓦解,崩溃
embankment |  n. 堤防, 筑堤
embassy |  n. 大使馆,大使,外使团
eradicate |  v. 根除, 扑减, 根绝
evacuate |  vt. &vi. 疏散, 撤出, 排泄
expedient |  n. 权宜之计,临时手段 // adj. 权宜的,方便的,有用的
fallible |  adj. 易错的,可能犯错的
formation |  n. 构造,编队,形成
frontier |  n. 边界,边境，尖端，边缘
gratuity |  n. 赠物,赏钱,贺仪
harangue |  n. 长篇大论；高谈阔论；热烈的演说 // vt. 向…滔滔不绝地演讲；大声训斥 // vi. 高谈阔论；慷慨陈词
hierarchy |  n. 等级制度，层级[计],统治集团
informative |  adj. 情报的, 使知道消息的, 见闻广博的
interim |  adj. 中间的,暂时的,临时的 // n. 中间时期,过渡时期,暂定
intransigent |  adj. 非妥协性的 // n. 不妥协的人
intrusion |  n. 闯入, 侵扰
mandate |  n. 命令, 指令, 要求，托管地 // vt. 把(某一地区)置于委任管理下
matriculate |  v. 准许入学,录取
militant |  adj. 好战的, 积极从事或支持使用武力的
momentous |  adj. 重要的, 重大的
negligence |  n. 疏忽, 粗心大意
obligatory |  adj. 强制性的, 义务的, 必须的
paranoia |  n. [心]妄想狂, 偏执狂
pedestal |  n. 基架, 底座, 受人尊敬的地位 // vt. 加座, 搁在台上
permissible |  adj. 可允许的,可容许程度的
ponderous |  adj. 笨重的, 笨拙的，乏味的
probation |  n.鉴定,试用,缓刑
problematic |  adj. 问题的, 有疑问的
pronounceable |  adj. 可发音的, 可断言的
quandary |  n. 困惑, 迷惑, 为难
regime |  n. 政权，政体；社会制度；管理体制
sanity |  n. 神智健全, 头脑清楚, 健全
siege |  n. 包围, 围攻
sovereign |  n. 元首,金镑 // adj. 具有主权的,至高无上的,极好的,完全的
suicidal |  adj. 自杀的, 自杀性的, 自我毁减的
syllabus |  n. 摘要,课程表
symposium |  n. 讨论会(论文集, 酒会)
tactic |  n. 战略,策略 // adj. 战术的,有策略的
thesaurus |  n. 同类词汇编，辞典, （知识）宝库
transitive |  adj. 传递的，过渡的，[语]及物的
memorize |  v. 记住, 记录, 记下
escalate |  vt. 扩大,升高,增强 // vi. 逐步升级
integrate with |  v. 与 ... 成为一体，与 ... 相结合
occupy |  vt. 占领,占,住进
entitle to |  vt. 有资格(有权)
energetic |  adj. 精力旺盛的,有力的,能量的
benevolent |  adj. 仁慈的,乐善好施的
plausible |  adj. 似真实的,似合理的,说得蛮像回事的
transient |  adj. 短暂的 // n. 短期居留者,瞬间的变化
constituent |  n. 成份,选民,构成物 // adj. 构成的,组织的,有提名权的
impetus |  n. 动力,推动力
domain |  n. 领域 // [计算机] 域
dwindle |  v. 减少, 缩小
embark on |  上（船、飞机等），从事，着手
inaugurate |  v. 举行就职典礼,举行仪式 // v. 开始,开创
anecdote |  n. 轶事,奇闻
accommodate |  vi. 使自己适应 // vt. 使一致，和解；提供方便；容纳；顾及
render |  vt. 使成为, 提供, 报答, 着色; 执行, 实施 // vi. 给予补偿 // n. 交纳, 粉刷, 打底
adore |  v. 崇拜,爱慕,喜爱
arouse |  vt. 唤醒,激发,激起 // vi. 唤醒
ban |  n. 禁令 // v. 禁止 // vt. 禁止,取缔
bear |  n. 熊 // v. 忍受,负荷 // v. 结果实,生子女
belong |  vi. 属于，适合于
communicate |  vt. 传达, 传播 // vi. 交流, 沟通, 联通
conquer |  vt. 征服, 战胜, 克服 // vi. 得胜
deepen |  vt. 使...加深, 使...强烈 // vi. 加深，变浓
deliver |  vt.发表； 递送； 交付； 使分娩 // vi.投递； 传送
dispose |  vt. 倾向于,处置 // vi. 销毁
exert |  vt. 运用, 施加（压力，影响等）
abate |  v. 缓和, 减弱
acrobat |  n. 杂技演员，见风使舵的人
apparel |  n. 衣服,装具 // vt. 使...穿衣,装饰
beautician |  n. 美容师
booklet |  n. 小册子
booth |  n. 电话亭,货摊,小间
cement |  n. 水泥,纽带,接合剂,牙骨质,补牙物,基石 // vt. 接合,用水泥涂 // vi. 接合起来
chic |  n. 别致的款式, 流行样式, 时尚 // adj. 别致的
cloakroom |  n. 衣帽间，休息室，&lt;英&gt;盥洗室
colonnade |  n. 柱廊，列柱
commentary |  n. 实况报道，现场解说,评论,注释，批评
commentate |  vi. 作实况报道,评述
compile |  v. 编译,编辑,编纂 // [计算机] 编译
culminate |  v. 达到顶点或高潮, 以...告终 // vi. 达到顶点 // vt. 使达高潮, 使结束
devour |  vt. 吞食,耗尽,吞没,贪婪的享用
dilapidated |  adj. 毁坏的, 荒废的, 要塌似的 // 动词dilapidate的过去式和过去分词
drainage |  n. 排水；排水系统；污水；排水面积
eminent |  adj. 著名的, 卓越的
evict |  v.驱逐 // v.依法收回（财产等）
excerpt |  n. 摘录 // v. 摘录,摘要 // vt. 摘,引用
explanatory |  adj. 说明的, 解释的
fidelity |  n. 忠实,忠诚，准确性
finale |  n. 结局,终了,最后的一个乐章
flagstone |  n. 石板
fortify |  vt. 强化，增强，筑防御工事于，（物质或精神上）支持或鼓励 // vi. 构建防御工事
frock |  n. 罩袍, 僧衣，女上装 // vt. 穿罩衫，授以神职
funnel |  n. 漏斗；烟囱 // vt. 通过漏斗或烟囱等；使成漏斗形 // vi. 通过漏斗等；成漏斗形
grate |  vt.磨碎，压碎； 装格栅 // vi.发出刺耳的摩擦声； 使人烦恼难受 // n.炉格，炉箅； 刺耳的声音
gymnasium |  n. 体育馆, 健身房 // n.（德国等培养学生升入大学的）大学预科，高级中学 // (复数）gymnasia或gymnasiums
leaflet |  n. 小叶,传单 // vt.& vi. 散发传单
masquerade |  n. 化妆舞会 // v. 化装
mime |  n. 哑剧, 哑剧演员，滑稽演员，模仿 // vt. 出演滑稽戏，做哑剧表演，模仿，模拟 // vi. 演出哑剧角色
occupant |  n. 占有者, 拥有者，占领者，居住者
periodical |  n. 期刊 // adj. 周期的, 定期的
phony |  adj. 假的, 伪造的，欺骗的 // n.假货，赝品，骗子 // suf. 表声音
placard |  n. 招贴, 布告 // vt. 张贴布告
postscript |  n. 附笔
quaint |  adj. 古雅的, 离奇有趣的, 奇怪的
recreation |  n. 消遣, 娱乐
remainder |  n. 剩余物, 其他的人, 残余 vt. 廉价出售 adj. 剩余的
affiliate |  n. 联号(联播台,同伙),附属机构,分公司 // vt. &vi. 合并(使...加入,追源)
shanty |  n. 简陋小屋，(水手唱的)劳动号子 // =chantey，chanty
slate |  n.板岩,石板,石片,石板色,候选人名单 // adj. 暗蓝灰色的,含板岩的 // vt. 用石板覆盖,痛打,提名,预订
stadium |  n. 露天体育场,竞技场
storey |  n. 楼层 // =story（美）
subscribe |  vt. 签名,签署,支持 // vi. 签名,签署,定期捐赠,订阅
symmetry |  n. 对称(性), 匀称, 整齐
telex |  n. 电传 // vt. 发电传
tenancy |  n. 租用，占有，租期，租用权
terminate |  adj. 有结尾的,有限的 // vt. 结束,终止,满期 // vi. 达到终点
tournament |  n. 比赛,锦标赛,(中世纪的)骑士比武
trapeze |  n. &lt;体&gt;  吊杠（杂技演员和体操运动员用的
ventilate |  vt. 使...空气流通，通风
versus |  prep. 对；与...相对；对抗
voucher |  n. 证人,保证人, 代金券 // vt. 证明, 为...准备凭据, 发给...凭证
wrestle |  v. 摔角, 斗争，用力举起 // n. 摔角, 角力, 扭斗
expand |  vt. 增加,详述,扩展,使...膨胀 // vi. 扩展,增加,详述
express |  n. 快车, 快递, 专使 // adj. 急速的, 明确的, 直接的 // adv. 用快递; 特意地 // vt. 表达, 表示; 挤压出; 快递
forbid |  vt. 禁止,妨碍, 阻止
foster |  adj. 收养的,养育的 // v. 养育,抚育,培养 // n. (Foster)人名；(英、捷、意、葡、法、德、俄、西)福斯特
gain |  n. 增益, 获得, 利润 // vt. 得到, 增进, 获利 // vi. 增加, 得到, (钟, 表等)走得快
interrupt |  n. 中断 // vt. 打断,妨碍 // vi. 插嘴 // [计算机] 中断
pose |  n. 姿势,姿态,装模作样 // vt. 提出(问题),引起,定格 // vi. 摆姿势,装模作样
provide |  vi. 供给, 提供 // vt. 提供; 规定; 准备
punish |  惩罚, 处罚
raise |  n. 上升, 增高; 高地 // vt. 升起, 举起, 饲养; 提出, 引起
realize |  vt.实现； 了解，意识到； （所担心的事）发生； 以…价格卖出 // vt.& vi.变卖，赚得
remove |  n. 间距, 移动 // vt. 除去,开除, 移动, 取下, 拿走 // vi. 迁徙,离开,搬迁
safeguard |  n. 保卫,保护措施或条款 // v. 保卫,保护
satisfy |  vt. 使...满意, 使...信服 // vi. 足够, 取悦
shoulder |  n. 肩膀, 角度, 交接处 // vt. 肩负,承担,用肩推挤 // vi. 用肩推挤
struggle |  n. 竞争,努力,奋斗 // v. 努力,奋斗,挣扎
widen |  vt. 弄宽
assessment |  n. 估价, 评估
dignity |  n. 尊严, 高贵, 端庄
discrimination |  n. 歧视, 辨别力, 识别
distinction |  n. 区别; 卓越; 殊荣
greed |  n. 贪心, 贪婪
harmony |  n. 和弦,协调,和睦,调和
obesity |  n. 肥胖, 肥大
peer |  vi. 凝视，盯着看；窥视 // vt. 封为贵族；与…同等 // n. 贵族；同等的人
peril |  n. 危险,冒险 // vt. 置...于险境,冒险
prejudice |  n. 偏见,成见,伤害 // v. 使...存偏见,使...有成见,伤害
prospect |  n. 景色, 希望, 展望 // v. 探勘, 寻找
sacrifice |  n. 牺牲,供俸,祭品 // vt. 牺牲,祭祀,贱卖 // vi. 献祭,(棒球)作牺牲一击
subsistence |  n. 生存, 生活
conceivable |  adj. 想得到的, 可想像的, 可能的
congruent |  adj.合适的，一致的，全等的
cornstarch |  n. 玉米淀粉，又称玉米粉或玉蜀黍淀粉
croissant |  n. 牛角包
delectable |  adj. 快乐的, 可喜的, 愉快的，美味的
dingy |  adj. 昏暗的；肮脏的
disreputable |  adj. 声名狼籍的，见不得人的，品格不端的
edible |  n. 食品, 食物 // adj. 可食用的
equivocal |  adj. 意义不明确的, 模棱两可的
exceptional |  adj. 例外的,异常的,特别的
fluff |  n. 软毛, 柔毛, 绒毛
greasy |  adj. 油腻的, 滑溜溜的, 泥泞的
grill |  n. 烤架,铁格子,烤肉 // vt. 烧,烤,严加盘问
haphazard |  adj. 偶然的，随意的，杂乱无章的 // adv. 杂乱地, 任意地
haw |  n.山楂； 吆喝牲畜左转；呃 // v.（使）向左转，支吾
idiosyncrasy |  n. 特质
insipid |  adj. 乏味的, 枯燥的
integral |  adj. 构成整体所必需的,完整的 // n. [数学] 积分, 完整, 部分
invincible |  adj. 不可征服的, 难以制服的
kernel |  n. 核心, 中心, 精髓 // [计算机] 核心
ketchup |  n.蕃茄酱 // =catchup
liquor |  n. 酒
lucrative |  adj. 有利益的,获利的,合算的
majestic |  adj. 宏伟的, 高贵的, 壮丽的
maximize |  v. 取...最大值,最佳化 // [计算机] 最大化
meringue |  n. 蛋白与糖制成的糕饼
nicety |  n. 精确，谨慎，精细，细微的区别
normalize |  v. 使常态化, 使合标准, 使合规格
oatmeal |  n. 燕麦片, 燕麦粥
outstrip |  v. 超过,跑过 // vt. 胜过,超过
palatable |  adj. 美味的, 愉快的
pastry |  n. 面粉糕饼, 馅饼皮
pellet |  n. 小球, 小子弹
pertain |  vi. 从属, 关于
pertinent |  adj. 相关的, 中肯的, 切题的
placid |  adj. 安静的, 平和的
profuse |  adj. 很多的, 丰富的，浪费的
pungent |  adj. 苦痛的,刺激性的,严厉的
rivet |  n. 铆钉 // v. 铆接,固定,钉牢 // v. 集中(目光、注意力)，吸引
sausage |  n. 香肠,腊肠
scrap |  n.  小片,残余物,废料,打架 // vt. 扔弃 // vi. 互相殴打
sporadic |  adj. 不定时发生的, 零星的
stale |  adj. 不新鲜的, 陈腐的, 失效的 // vt. 使腐坏 // vi. 变得不新鲜, 腐坏,(动物)撒尿 // n. (动物的)尿
starchy |  adj. 含淀粉的, 刻板的
straw |  n. 稻草, 麦杆, 吸管 // adj. 用稻草做的, 用来作稻草的, 麦杆色的, 无价值的, 象稻草人的, 非正式民意测验所发现的
variegated |  adj. 杂色的, 斑驳的, 形形色色的，富于变化的 // 动词variegate的过去式和过去分词形式
width |  n. 宽度,广度,某一宽度的材料
survival |  n. 生存,幸存者
torture |  n. 拷问,痛苦 // vt. 拷问,使痛苦,曲解
trait |  n. 特征,特点,特性,品质
vegetation |  n. 植物,草木,(植物)生长
vigor |  n. 活力, 精力
yearn |  v. 渴望, 想念
abundant |  adj. 丰富的,充裕的
advantageous |  adj. 有利的，有助的，有益的
affluent |  adj. 富裕的 // n. 支流；富人
appeal |  n. 恳求, 上诉, 吸引力 // n. 诉诸裁决 // v. 求助, 诉请, 呼吁; 有吸引力
athletic |  adj. 运动的,活跃的,健壮的
bewilder |  vt. 使迷惑，使...不知所措
cognitive |  adj. 认知的,认识的,有认识力的
contagious |  adj. 传染性的,会蔓延的,会传播的
cooperative |  adj. 合作的,共同的 // n. 合作社
depressed |  adj. 沮丧的,降低的 vt. 压低,使沮丧,削弱(depress的过去式及过去分词)
diligent |  adj. 勤奋的, 用功的
disgusting |  adj. 令人厌恶的
distinguished |  adj. 卓著的 // v. 区别 // vbl. 区别
diverse |  adj. 不同的,相异的,多种多样的
ecological |  adj. 生态的, 生态学的
effective |  adj. 有效的,有影响的
embarrassed |  adj. 尴尬的，局促不安的，拮据的
enlightened |  adj. 被启发的, 进步的, 文明的 // 动词enlighten的过去式和过去分词
extravagant |  adj. 奢侈的,浪费的,过度的,大量的
immediate |  adj. 立即的, 即刻的, 直接的, 最接近的
inevitable |  adj. 不可避免的, 必然(发生)的
innovative |  adj. 革新的, 创新的
justifiable |  adj. 可辩解的, 可证明的, 有理的
liberal |  n. 自由主义者, 宽容大度的人, (Liberal)自由党人 // adj. 无偏见的, 慷慨的, 不拘泥的, 宽大的, 开明的
perspire |  v. 出汗, 流汗
avert |  vt. 转开,避免,防止
bolster |  n. 长枕,靠垫 // vt. 支持,鼓励
brunt |  n. 正面的冲击, 主要的压力
bulge |  n. 膨胀,优势,暴增 // vt. 使...膨胀 // vi. 膨胀,充满
bustle |  n. 喧哗，匆忙 // n. (旧时）裙撑，衬垫 // v. 奔忙, 催促
categorize |  vt. 分类
clearance |  n. 清除,解除,森林开拓
clench |  v. 紧握, 紧咬，牢牢地抓住, 确定 // n. 牢牢抓住, 钉紧
coil |  n. 卷,骚动,【电】线圈, 绕组 // vt. &vi. 盘绕,卷
coincidence |  adj. 同时发生的 // n. 巧合
crumple |  v.（使)起皱，(使)崩溃 // n. 压痕，皱痕
crush |  n. 压碎, 拥挤的人群, 迷恋, 关键时刻, 果汁, 榨汁酿酒 // vt. 压破, 征服, 挤入, 镇压 // vi. 被压碎, 挤
dangle |  v. 摇晃 地悬挂着
detract |  vi. 减损  // vt. 转移
devoid |  adj. 全无的, 缺乏的
discredit |  vt. 使...不可信, 怀疑, 损害...的信用 // n. 失信, 怀疑, 不信任
disentangle |  v. 解开, 松开，摆脱，解决（纠纷等）
eddy |  n. 逆流, 漩涡 // v. 起漩涡
embedded |  adj. 植入的, 内含的, 深入的 // v. 埋入, 植入, 深入 // vbl. 埋入, 植入, 深入
excavate |  v. 挖掘, 挖开, 凿通
flick |  n. 快速的轻打,轻打声,轻溅 // vt. 轻弹,轻打,忽然摇动,按开开关 // vi. 轻击,快速翻阅
fringe |  n. 流苏,次要,（地区或群体）边缘,（沿…边缘的）一排（树木、房屋等）vt. 用流苏修饰,镶边
grind |  n. 磨, 碾, 挤摩擦声, 无聊的苦工作 // vt. 磨, 碾, 挤压, 摇动手柄 // vi. 磨擦, 磨碎, 用功
growl |  n. 吠声, 不平, 咆哮声 // v. 怒吠, 咆哮, 吼
grudge |  n. 怨恨,恶意 // vt. 怀恨,嫉妒,吝惜
ignition |  n. 点火,点火器 // n. 【化】灼热 // n. 【机】发火装置
inscribe |  v. 题写，铭刻于，题赠 // （英）登记 // [数] 使内接
intersperse |  v. 散布,点缀 // vt. 散布,散置,点缀
jostle |  v.&amp;n. 推,撞,挤(人) // vt. 推撞
knit |  vt. 编织, 密接, 结合, 皱眉 // vi. 编织, 变得紧凑, 愈合 // n. 编织
lapse |  n. 过失,流逝,失效,抛弃信仰,间隔 // vi. 堕落,停止,失效,流逝 // vt. 使失效
nibble |  n. 轻咬, 啃 // v. 一点点地咬, 慢慢啃，吹毛求疵
overlap |  n. 重叠,重复 // vt. 重叠,重复 // vi. 有重叠部分 // [计算机] 重叠
pinch |  n. 捏, 撮, 困苦, 偷窃 // vt. 掐,使...困苦, 偷窃
prodigious |  adj. 巨大的,奇异的 // n. 奇迹
quiver |  v. 颤抖, 振动 // n. 震动, 颤抖, 箭袋，箭袋内的箭
ramification |  n. 分枝, 分叉, 衍生物, 支流
ramify |  v. (使)分枝, (使)分叉, (使)成网状
relinquish |  v. 放弃,放手,让渡
retrieve |  vt. 挽回,恢复,回忆,补偿 // vi. 找回猎物 // n. 取回,恢复
rinse |  vt. 漱；冲洗掉；漂净 // n. 冲洗；漂洗；[轻] 染发剂；染发 // vi. 冲洗掉；漂净
ruffle |  n. 绉褶, 生气, 褶裥饰边，涟漪 // vt. 弄绉, 给...打褶皱, 扰乱 // vi. 变皱，发脾气
scurry |  vt. 快跑(飞散) // n. 快跑(飞散)
secular |  n. 牧师,凡人 // adj. 世俗的,现世的,不朽的
shamble |  n. 蹒跚, 摇晃的脚步 // vi. 蹒跚地走, 摇摇晃晃地走, 摇晃不稳
shrink |  n. 收缩,萎缩 // vi. 收缩,退缩,萎缩 // vt. 使收缩
skew |  adj. 斜交的(不对称的,误解的) // n. 斜交(歪斜,歪轮,斜砌石) // vt. 歪斜,扭转 // vi. 歪斜,斜视
slouch |  n. 没精打采的样子, 耷拉, 笨人 // v. 没精打采地站, 坐
splash |  n. 飞溅的水, 污点, 卖弄 // v. 溅湿, 溅开
sprint |  vi. 全力奔跑,冲刺 // n. 短距离赛跑，冲刺 // n. 斯普林特(财富500强公司之一, 总部所在地美国, 主要经营电讯)
squat |  n. 蹲 // adj. 蹲着的, 矮胖胖的 // v. 蹲下, 坐
squirt |  v. 喷出,溅迸,注射 // n. 水枪,注射器,喷出
stumble |  n. 绊倒,失策 // vi. 绊倒,失策,踌躇,无意中发现 // vt. 绊倒,困惑
swerve |  v. 突然转向 // n. 转向
tantalize |  vi. 逗惹，吊胃口, 令人可望而不可及 // vt. 使着急
toddle |  vi. （幼儿等）东倒西歪地走, 溜哒, 散步 // n. （幼儿等）东倒西歪的走路, 刚学走步的小孩
vibrate |  vt. (使)振动,(使)摇摆 // vi. 回响，颤动
vindicate |  vt. 维护；证明…无辜；证明…正确
wield |  vt. 行使，运用，支配，挥舞，使用(武器等)
wreathe |  v. 环绕, 盘绕, 作成花圈
nutritious |  adj. 有营养成份的,营养的
offensive |  adj. 令人不快的,侮辱的,攻击用的 // n. 进攻
outright |  adj. 率直的, 完全的, 总共的 // adv. 率直地, 立刻地, 一直向前
outstanding |  adj. 突出的, 显著的, 未支付的
passionate |  adj. 热情的, 易怒的, 激情的
peculiar |  adj. 奇怪的,古怪的,特殊的,独特的 // n. 特权
pessimistic |  adj. 悲观的, 悲观主义的
preceding |  adj. 在前的,在先的
prestigious |  adj. 享有声望的, 声望很高的
innovation |  n. 创新, 革新
exchange |  n. 交换,交换物,汇兑,交易所 // vt. &vi. 交换,交易,兑换
spot |  n. 污点, 地点, 斑点; 职位 // adj. 当场的, 现实买卖的 // v. 使沾上污点, 认出, 用灯光照射
hurricane |  n. 飓风,飓风般猛烈的东西 // adj. 有防风罩的
silicon |  n. 硅
intersection |  n. 交集,十字路口,交叉点 // [计算机] 交集
permanent |  adj. 永久的, 持久的 // n. (口)烫发
result from |  起因于
maneuver |  n. 演习,调遣,策略 // vt. 调遣,演习,巧妙地操纵 // vi. 调遣,演习,用计策
interpretation |  n. 解释,演出,翻译,互動
collision |  n. 碰撞, 冲突
recourse |  n. 依赖, 求助, 追索权
unquote |  n. 引用文结束
dilute |  vt. 冲淡,稀释 // adj. 冲淡的,稀释的,微弱的
computerize |  vt. 用电脑处理, 使电脑化
consolidate |  v. 巩固,联合,统一 // [计算机] 使固定
contemplate |  vt. 注视,沉思,打算
cultural |  adj. 文化的,和养动植物有关的
cybercrime |  n. 网络犯罪
cyberspace |  电脑空间
dehumanize |  v. 使失掉人性, 使成兽性
disseminate |  vt. 散播, 公开, 宣传
exorbitant |  adj. (价格等)过高的，不合法的
foreland |  n. 沿海地区, 海角, 海岸地
hitherto |  adv. 到目前为止, 迄今
muster |  v.集合，收集，鼓起，激起 // n.集合，检阅，集合人员，点名册
procure |  vt. 获得, 取得, 促成 // vi. 拉皮条
puncture |  n.刺伤；小洞；（尤指皮肤上被刺破的）扎孔 // v.在…上扎孔（或穿孔）；（被）刺破；使突然泄气；挫伤（锐气等）
redistribute |  vt. 重新分配, 再区分
rendezvous |  n. 约会, 约会地点, 汇合点 // vi. 汇合, 集合 // vt. 使汇合, 使在汇合地点相遇
shelve |  vt. 放在架子上，搁置 // vi. 倾斜
stagger |  n. 蹒跚,踌躇,摇摆不定 // vi. 蹒跚,犹豫,动摇 // vt. 使摇晃,使吃惊,使犹豫 // vt. 使交错,错开时间
stoop |  n. 佝偻, 屈服 // v. 弯下, 弯下上身, 屈服
strew |  vt. 散播, 撒满
superfluous |  adj. 多余的，过剩的
transcend |  v. 超越
tremor |  n. 震动, 颤动, 战栗，兴奋，地震
underneath |  adv. 在下面 // n. 下部, 底部 // prep. 在...下面
but for |  倘没有, 要不是
deliberately |  adv. 慎重地,故意地
purist |  n. 纯化论者，纯粹主义者
cope with |  vt. 对付(应付,克服)
antidote |  n. 解毒剂, 解药 // n.(喻)矫正方法
prominent |  adj. 杰出的,显著的,突出的
dimension |  n. 尺寸, 次元, 容积, 维度 // n. 范围; 方面 // vt. 标尺寸; 形成...尺寸
resist |  v. 抵抗, 耐得住, 压制 // n. 保护膜
item |  n. 项目,条款， 一件商品（或物品） // adv. 也
treatment |  n. 治疗,疗法,处理
admit |  vt.& vi.许可进入； 承认，供认 // vt.允许； 确认 // vi.承认； 允许
inhale |  v. 吸入,吞咽
classification |  n. 分类,分级
institute |  n. 学会,学院,协会 // vt. 创立,开始,制定
fragrance |  n. 香味
subordinate |  n. 属下,附属物 // adj. 下级的,次要的,附属的 // vt. 使居下位,使服从,把...放在次要
evaluate |  vt. 评估,评价
grant |  vt.承认； 同意； 准许； 授予 // n.拨款； 补助金； 授给物（如财产、授地、专有权、补助、拨款等） // vi.同意
standard |  n.标准，规格； 旗，军旗； 度量衡标准； 直立支柱 // adj.标准的，合格的； 普遍的，一般的； 公认为优秀的
insecure |  adj. 不安全的, 不肯定的，不牢靠的, 局促不安的
alluvial |  adj. [地质]冲积的, 淤积的 // n. 冲积土，淤积土
advertise |  vi. 登广告 // vt. 为...做广告, 宣传
devote |  vt. 投入于,献身
appetite |  n. 爱好,嗜好,食欲,胃口,欲望
access |  n.入口，出口； 接近，进入； 增长； 爆发 // vt.接近，进入； 使用，接近，获取
conduct |  n. 行为, 举动, 品行 // v. 引导, 指挥, 管理 // vt. 导电, 传热
particle |  n. 微粒,质点,极小量
distinguish |  vt. 区别,辨认,特别关注 // vi. 区别
addiction |  n. 耽溺, 上瘾
alloy |  n. 合金 // vt. 使...成合金, 搀以劣质, 减低成色, 影响或贬损 // vi. 有合金能力
anomaly |  n. 异常, 反常
architectural |  adj. 建筑的,建筑学的,建筑术的
arson |  n. 纵火, 纵火罪
beekeeper |  n. 养蜂人 // =apiarist
beeswax |  n. 蜂蜡
burglary |  n. 盗窃行为
circulatory system |  循环系统
confinement |  n. 密封(限制,吸持)
congregate |  vt. 使集合, 聚集 // vi. 集合 // adj. 集体的
cosmetic |  n. 化妆品 // adj. 化妆用的
cruelty |  n. 残酷,残忍, 残酷的行为，虐待
despoil |  vt. 夺取, 掠夺
domicile |  n. 住所, 住宅
dominance |  n. 支配(控制, 统治, 权威, 优势)
drone |  n. 雄蜂, 游手好闲者, 嗡嗡声，无人驾驶飞机（或艇等），单调的低音 // vi. 发出嗡嗡的声音, 混日子 // vt. 单调低沉地说，过着单调无聊的日子
egocentric |  adj. 自我中心的, 利己的
empire |  n. 帝国
enslave |  vt. 使做奴隶, 使处于奴役的状态
forage |  n. 粮草, 饲料, 搜寻粮草 // v. 喂, 掠夺
harassment |  n. 困扰,烦扰,烦恼
herring |  n. 青鱼,鲱,紧密
hexagonal |  adj. 六角形的, 六边的, 底面为六角的
heyday |  n. 全盛期 // int. 嘿（喜悦、惊奇时所发声音）
honeybee |  n. 蜜蜂
hornet |  n. 大黄蜂类,难缠的人物
intruder |  n. 侵入者, 干扰者, 妨碍者
lagoon |  n. 泻湖(污泥贮留池,沼)
larva |  n. 幼虫，幼体
lavish |  adj. 大方的,丰富的,浪费的 // vt. 浪费,慷慨给予
lax |  adj. 松的, 松懈的, 不严的 // [语]松弛元音的
lure |  n. 饵,诱惑 vt. 引诱,诱惑
luxurious |  adj. 奢侈的, 豪华的
mandatory |  adj. 命令的, 强制性的, 受委托的 // n. 受托管理者
melon |  n. 甜瓜
metropolitan |  n. 大都市的居民,大主教,母国的居民 // adj. 大都市的,大主教区的,母国的
misleading |  adj. 使人误解的
mistaken |  adj. 犯错的, 错误的 // 动词mistake的过去分词
monotonous |  adj. 单调的
nationwide |  adj. 全国性的 // adv. 在全国范围内
needy |  adj. 贫穷的, 贫困的, 生活艰苦的
newsreel |  n. 新闻短片
nimble |  adj. 敏捷的，伶俐的， 精明的
noble |  adj. 高尚的, 宏伟的, 贵族的, 高贵的 // n. 贵族
obese |  adj. 极肥胖的
obscene |  adj. 淫秽的, 猥亵的
octagonal |  adj. 八边形的, 八角形的
otter |  n. 水獭, 水獭皮
ovary |  n. 卵巢, [植]子房
panorama |  n. 全景，全景画，全景照片，概观，一连串景象或事物
pheromone |  n. 〈生化〉信息素
photographer |  n. 摄影师
photographic |  adj. 摄影的，逼真的
pinniped |  adj. 鳍足类的 // n. 鳍脚亚目哺乳动物
playwright |  n. 剧作家
pollen |  n. 花粉 // v. 授粉给
porpoise |  n. 海豚 // vi. (船，鱼雷)在水面急行
prey |  n. 被掠食者,牺牲者 // vi. 捕食,掠夺,使...苦恼
projection | n. 发射，计划，突出部分
projector |  n. 放映机(探照灯, 发射装置, 设计者, 制图投射线)
puppet |  n. 木偶, 傀儡
realistic |  adj. 现实的, 现实主义的
screenplay |  n. 电影剧本, 剧本
screenwriter |  n. 电影剧本作家, 编剧家
seine |  塞纳河(法国北部河流,流经巴黎)
shutter |  n. 百叶窗, 遮门, 快门 // v. 装以遮门, 以百叶窗遮闭
slide |  n. 滑,幻灯片,雪崩,山崩,滑坡,滑梯 // vt. 使滑 // vi. 滑,跌落
snout |  n. 鼻口部,鼻子,蛇管的前端
soundtrack |  n. 声道，电影配乐
squid |  n. 鱿鱼
strand |  n.（绳子的）股，绞； 海滨，河岸； （思想等的）一个组成部分 // vt.使滞留，使搁浅； 使陷于困境 // vi.搁浅； 陷入困境
Technicolor |  n. [商标]彩色电影摄影法, 鲜明的色彩, 华丽的色彩
telecommuting |  n.远程办公,远程联机 // 动词telecommute的现在分词
trilogy |  n. 三部曲
ungrateful |  adj. 忘恩负义的, 讨人厌的
unshakable |  adj. 不可动摇的
vaudeville |  n. 滑稽通俗喜剧,杂耍
weary |  adj. 疲倦的,厌烦的 // vt.& vi. 疲倦,厌烦,生厌
